9 8
39
39 38 30 31 23 15 7 6 5 13 21 20 28 36 35 27 19 18 10 11 3 2 1 0 8 16 24 25 33 32 40 48 56 57 65 66 67 68 69 61 62 63 55 47 46 45 44 52 60 59 58 50 42 
1 1 1 1 0 1 1 1 
1 0 1 1 0 1 0 1 
1 0 1 1 1 1 0 1 
1 1 0 1 1 0 1 1 
1 1 0 1 1 0 1 2 
1 0 1 0 1 1 1 1 
1 0 1 0 1 0 0 1 
1 1 1 1 1 1 1 1 
0 1 1 1 1 1 0 0 

Complexity: 3
Time: 71 seconds or 1.18 minutes or 0.02 hours