9 8
47
47 55 63 71 70 62 61 60 68 67 66 58 57 65 64 56 48 40 41 42 34 35 43 51 52 44 45 46 38 39 31 23 22 21 29 28 20 19 18 17 25 24 16 8 0 1 2 3 11 12 13 14 6 7 
1 1 1 1 0 0 1 1 
1 0 0 1 1 1 1 0 
1 1 1 1 1 1 1 1 
1 1 0 0 1 1 0 1 
0 0 1 1 0 0 1 1 
1 1 1 1 1 1 1 2 
1 0 0 1 1 0 0 1 
1 1 1 0 1 1 1 1 
1 1 1 1 1 0 1 1 

Complexity: 3
Time:  6 seconds or 0.1 minutes or 0 hours