11 8
67
67 68 69 61 53 52 51 43 35 36 37 29 28 20 12 11 3 4 5 6 7 15 14 22 23 31 39 38 46 54 55 63 71 79 87 86 78 77 76 75 83 82 81 73 72 64 65 66 58 50 42 41 49 48 40 32 24 25 26 18 17 9 1 0 
1 1 0 1 1 1 1 1 
0 1 0 1 1 0 1 1 
0 1 1 0 1 0 1 1 
1 1 1 0 1 1 0 1 
1 0 0 1 1 1 1 1 
1 1 1 1 0 0 1 0 
1 1 1 1 1 1 1 1 
0 0 1 0 0 1 0 1 
1 1 1 2 1 1 0 1 
1 1 0 1 1 1 1 1 
0 1 1 1 0 0 1 1 

Complexity: 4
Time: 739 seconds or 12.31 minutes or 0.21 hours