10 9
27
27 18 9 10 1 2 3 4 13 22 21 20 29 38 37 36 45 46 55 64 65 66 57 48 49 50 41 40 31 32 23 24 15 6 7 16 17 26 35 34 43 52 51 60 61 62 71 70 79 88 87 78 77 68 67 76 85 84 83 74 73 72 
0 1 1 1 1 0 1 1 0 
1 1 0 0 1 0 1 1 1 
1 0 1 1 1 1 1 0 1 
2 0 1 0 1 1 0 1 1 
1 1 1 0 1 1 0 1 0 
1 1 0 1 1 1 1 1 0 
0 1 0 1 0 0 1 1 1 
0 1 1 1 1 1 0 1 1 
1 1 1 0 1 1 1 1 0 
0 0 1 1 1 0 1 1 0 

Complexity: 4
Time: 50 seconds or 0.84 minutes or 0.01 hours