10 9
16
16 17 8 7 6 5 14 13 12 11 2 1 10 9 18 27 36 37 46 47 56 57 58 67 68 59 50 41 40 39 38 29 20 21 22 23 32 33 34 25 26 35 44 43 52 53 62 61 60 69 78 79 80 89 88 87 86 85 84 75 74 83 82 73 64 63 54 
0 1 1 0 0 1 1 1 1 
1 1 1 1 1 1 0 2 1 
1 0 1 1 1 1 0 1 1 
1 0 1 0 0 1 1 1 1 
1 1 1 1 1 1 0 1 1 
0 1 1 0 0 1 0 1 1 
1 0 1 1 1 1 1 1 1 
1 1 0 0 1 1 1 0 0 
0 1 1 1 0 0 1 1 1 
0 1 1 1 1 1 1 1 1 

Complexity: 4
Time: 79 seconds or 1.32 minutes or 0.02 hours