10 9
38
38 37 46 45 54 63 72 73 82 83 74 65 56 57 58 49 40 39 30 21 22 23 32 41 42 51 60 69 68 77 76 75 84 85 86 87 78 79 80 71 70 61 52 43 44 35 34 25 26 17 16 15 6 5 4 3 12 11 2 1 0 9 10 19 28 27 
1 1 1 1 1 1 1 0 0 
1 1 1 1 0 0 1 1 1 
0 1 0 1 1 1 0 1 1 
1 1 0 1 0 1 0 1 1 
0 1 2 1 1 1 1 1 1 
1 1 0 0 1 0 1 1 0 
1 0 1 1 1 0 1 1 0 
1 0 1 0 0 1 1 1 1 
1 1 1 1 1 1 1 1 1 
0 1 1 1 1 1 1 0 0 

Complexity: 4
Time: 5935 seconds or 98.92 minutes or 1.65 hours