10 8
57
57 49 50 42 34 35 27 19 20 21 29 30 31 39 38 37 36 44 52 60 61 62 54 46 47 55 63 71 79 78 77 76 68 67 59 58 66 74 73 72 64 56 48 40 32 24 25 17 16 8 9 1 2 10 11 3 4 5 13 14 15 7 
0 1 1 1 1 1 0 1 
1 1 1 1 0 1 1 1 
1 1 0 1 1 1 0 0 
1 1 0 1 0 1 1 1 
1 0 1 1 1 1 1 1 
1 0 1 0 1 0 1 1 
1 1 1 0 1 0 1 1 
1 2 1 1 1 1 1 1 
1 0 1 1 1 0 0 1 
1 1 1 0 1 1 1 1 

Complexity: 4
Time: 315 seconds or 5.26 minutes or 0.09 hours