11 8
68
68 67 59 51 50 42 34 35 43 44 36 37 29 21 20 19 11 3 4 5 6 7 15 14 22 30 38 39 47 55 54 53 61 62 70 78 79 87 86 85 77 76 75 74 82 81 80 72 73 65 57 49 48 40 32 24 25 26 18 17 9 1 0 
1 1 0 1 1 1 1 1 
0 1 0 1 0 0 1 1 
0 1 1 1 1 1 1 0 
1 1 1 0 0 1 1 0 
1 0 1 1 1 1 1 1 
1 0 1 1 1 0 0 1 
1 1 1 1 0 1 1 1 
0 1 0 1 0 1 1 0 
0 1 0 1 2 0 1 0 
1 1 1 1 1 1 1 1 
1 1 1 0 0 1 1 1 

Complexity: 4
Time: 966 seconds or 16.1 minutes or 0.27 hours