10 9
3
3 4 13 22 21 12 11 2 1 10 9 18 27 28 29 38 39 48 57 58 49 40 41 32 23 24 15 6 7 16 17 26 35 34 43 44 53 52 51 60 61 62 71 80 79 78 87 86 77 68 67 76 75 84 83 74 65 64 55 46 45 54 63 72 81 
0 1 1 2 1 0 1 1 0 
1 1 1 1 1 0 1 1 1 
1 0 0 1 1 1 1 0 1 
1 1 1 0 0 1 0 1 1 
0 0 1 1 1 1 0 1 1 
1 1 0 1 1 0 1 1 1 
1 1 0 1 1 0 1 1 1 
1 1 1 0 1 1 0 0 1 
1 0 1 1 1 1 1 1 1 
1 0 1 1 0 1 1 0 0 

Complexity: 4
Time:  3 seconds or 0.05 minutes or 0 hours