11 8
59
59 60 61 69 70 71 79 87 86 78 77 76 75 83 82 74 66 65 73 72 64 56 57 49 50 42 41 40 32 33 25 24 16 8 9 17 18 10 2 3 4 5 13 12 20 28 27 35 43 44 36 37 45 53 54 55 47 39 31 30 22 14 6 7 
0 0 1 1 1 1 1 1 
1 1 1 0 1 1 1 0 
1 1 1 0 1 0 1 0 
1 1 0 1 1 0 1 1 
1 1 0 1 1 1 0 1 
1 1 1 1 1 1 0 1 
0 1 1 0 0 1 1 1 
1 1 0 2 1 1 0 0 
1 1 1 0 0 1 1 1 
1 1 1 1 1 1 1 1 
0 0 1 1 0 0 1 1 

Complexity: 4
Time: 707 seconds or 11.78 minutes or 0.2 hours