11 8
77
77 69 68 76 84 85 86 87 79 71 70 62 54 46 47 39 31 30 22 23 15 14 6 5 13 21 20 12 11 19 27 35 36 37 45 53 52 51 59 67 66 74 82 81 80 72 64 65 57 49 50 42 41 40 32 33 25 24 16 17 18 10 2 1 0 
1 1 1 0 0 1 1 0 
0 0 1 1 1 1 1 1 
1 1 1 1 1 1 1 1 
1 1 0 1 0 0 1 1 
1 1 0 1 1 1 0 1 
1 1 1 0 0 1 1 1 
0 1 1 1 1 1 1 0 
0 1 0 1 0 0 1 0 
1 1 1 1 1 1 1 1 
1 0 1 0 1 2 0 1 
1 1 1 0 1 1 1 1 

Complexity: 4
Time: 1851 seconds or 30.85 minutes or 0.51 hours