10 9
43
43 34 35 26 17 8 7 16 15 24 33 32 41 40 49 58 57 48 39 38 29 20 21 22 13 14 5 4 3 2 1 10 9 18 27 36 37 46 55 54 63 72 81 82 83 74 65 66 75 76 85 86 77 68 69 60 51 52 53 62 71 70 79 88 89 
0 1 1 1 1 1 0 1 1 
1 1 0 0 1 1 1 1 1 
1 0 1 1 1 0 1 0 1 
1 0 1 0 0 1 1 1 1 
1 1 1 1 1 1 0 2 0 
0 1 0 1 1 0 1 1 1 
1 1 0 1 1 0 1 0 1 
1 0 1 1 0 1 1 1 1 
1 0 1 1 1 1 0 1 0 
1 1 1 0 1 1 0 1 1 

Complexity: 4
Time: 1163 seconds or 19.39 minutes or 0.32 hours