10 8
60
60 59 58 50 42 34 26 27 35 36 44 52 53 54 62 63 71 79 78 77 69 68 76 75 74 73 72 64 65 57 49 41 40 32 24 16 17 9 1 2 3 11 19 20 12 4 5 6 7 15 14 22 23 31 30 29 37 38 39 47 
0 1 1 1 1 1 1 1 
0 1 0 1 1 0 1 1 
1 1 0 1 1 0 1 1 
1 0 1 1 0 1 1 1 
1 0 1 1 1 1 1 1 
1 1 1 0 1 0 0 1 
0 1 1 0 1 1 1 0 
0 1 1 1 2 0 1 1 
1 1 0 0 1 1 0 1 
1 1 1 1 1 1 1 1 

Complexity: 4
Time: 11 seconds or 0.18 minutes or 0 hours