9 9
46
46 55 54 63 72 73 74 65 66 57 48 39 30 29 38 37 36 27 18 19 10 9 0 1 2 3 12 21 22 23 14 5 6 7 8 17 26 25 24 33 32 41 50 49 58 67 76 77 78 79 80 71 70 69 60 61 52 43 44 
1 1 1 1 0 1 1 1 1 
1 1 0 1 0 1 0 0 1 
1 1 0 1 1 1 1 1 1 
1 0 1 1 0 1 1 0 0 
1 1 1 1 0 1 0 1 1 
0 2 0 1 1 1 0 1 0 
1 1 0 1 1 0 1 1 0 
1 0 1 1 1 0 1 1 1 
1 1 1 0 1 1 1 1 1 

Complexity: 4
Time: 110 seconds or 1.83 minutes or 0.03 hours