10 8
71
71 79 78 77 69 61 60 52 51 50 58 66 67 75 74 73 65 64 56 48 40 41 42 34 35 36 28 29 37 45 53 54 62 63 55 47 39 31 30 22 23 15 7 6 5 13 12 4 3 2 10 9 8 16 24 25 26 18 19 
0 0 1 1 1 1 1 1 
1 1 1 0 1 1 0 1 
1 0 1 1 0 0 1 1 
1 1 1 0 1 1 1 1 
0 0 1 1 1 1 0 1 
1 1 1 0 0 1 0 1 
1 0 1 1 1 1 1 1 
1 0 1 0 1 1 1 1 
1 1 1 1 0 1 0 2 
0 1 1 1 0 1 1 1 

Complexity: 4
Time: 478 seconds or 7.97 minutes or 0.13 hours