11 8
67
67 66 58 59 51 52 44 43 35 34 26 18 19 27 28 29 37 38 39 47 46 54 62 61 69 70 71 79 87 86 85 84 76 75 74 73 81 80 72 64 56 48 49 41 40 32 24 16 17 9 1 2 3 4 12 13 5 6 14 22 23 
0 1 1 1 1 1 1 0 
0 1 0 0 1 1 1 0 
1 1 1 1 0 0 1 1 
1 0 1 1 1 1 0 0 
1 0 1 1 0 1 1 1 
1 1 0 1 1 0 1 1 
1 1 0 1 1 0 1 0 
1 0 1 1 0 1 1 0 
1 0 1 2 0 1 1 1 
1 1 1 1 1 0 0 1 
1 1 0 0 1 1 1 1 

Complexity: 4
Time: 182 seconds or 3.03 minutes or 0.05 hours