11 8
41
41 49 48 40 32 24 16 17 18 26 34 35 43 51 52 60 59 58 66 65 64 72 80 81 82 83 75 76 84 85 86 87 79 78 70 69 61 62 54 55 47 39 38 46 45 37 29 28 20 21 22 23 15 14 6 5 4 3 11 10 2 1 0 
1 1 1 1 1 1 1 0 
0 0 1 1 0 0 1 1 
1 1 1 0 1 1 1 1 
1 0 1 0 1 1 0 0 
1 0 1 1 0 1 1 1 
1 2 0 1 0 1 1 1 
1 1 0 1 1 0 1 1 
0 0 1 1 1 1 1 0 
1 1 1 0 0 1 1 0 
1 0 0 1 1 0 1 1 
1 1 1 1 1 1 1 1 

Complexity: 4
Time: 293 seconds or 4.89 minutes or 0.08 hours