9 9
14
14 5 6 7 8 17 26 35 44 43 34 25 24 33 32 31 40 39 38 29 20 21 12 13 4 3 2 1 10 19 18 27 36 45 46 55 64 63 72 73 74 65 56 57 58 49 50 51 60 61 62 71 80 79 78 69 68 67 76 
0 1 1 1 1 1 1 1 1 
0 1 0 1 1 2 0 0 1 
1 1 1 1 0 0 1 1 1 
1 0 1 0 1 1 1 1 1 
1 0 1 1 1 0 0 1 1 
1 1 0 0 1 1 1 0 0 
0 1 1 1 1 0 1 1 1 
1 1 1 0 1 1 1 0 1 
1 1 1 0 1 0 1 1 1 

Complexity: 4
Time: 398 seconds or 6.63 minutes or 0.11 hours