9 9
37
37 28 27 36 45 46 47 56 65 64 63 72 73 74 75 66 67 76 77 78 79 80 71 70 61 52 51 60 59 58 49 40 39 30 21 20 19 10 9 0 1 2 3 4 13 14 5 6 7 16 17 26 25 24 23 32 33 42 43 44 
1 1 1 1 1 1 1 1 0 
1 1 0 0 1 1 0 1 1 
0 1 1 1 0 1 1 1 1 
1 1 0 1 0 1 1 0 0 
1 2 0 1 1 0 1 1 1 
1 1 1 0 1 0 1 1 0 
0 0 1 0 1 1 1 1 0 
1 1 1 1 1 0 0 1 1 
1 1 1 1 1 1 1 1 1 

Complexity: 4
Time: 203 seconds or 3.39 minutes or 0.06 hours