9 9
42
42 33 32 41 40 31 22 23 14 13 12 11 2 3 4 5 6 7 16 25 26 35 44 53 52 51 60 59 58 57 48 39 38 29 20 19 10 9 18 27 36 37 46 55 64 63 72 73 74 65 66 75 76 67 68 77 78 79 70 71 80 
0 0 1 1 1 1 1 1 0 
1 1 1 1 1 1 0 1 0 
1 1 1 0 1 1 0 1 1 
1 0 1 0 1 1 1 0 1 
1 1 1 1 1 1 2 0 1 
0 1 0 1 0 0 1 1 1 
0 1 0 1 1 1 1 0 0 
1 1 1 1 1 1 0 1 1 
1 1 1 1 1 1 1 1 1 

Complexity: 4
Time: 1164 seconds or 19.4 minutes or 0.32 hours