10 9
10
10 9 0 1 2 3 4 13 14 5 6 7 8 17 26 25 24 33 42 41 40 39 30 31 22 21 20 19 28 37 36 45 54 63 64 65 56 47 48 49 58 67 68 69 60 51 52 43 44 53 62 71 80 79 78 87 86 85 76 75 74 83 82 81 
1 1 1 1 1 1 1 1 1 
1 2 0 0 1 1 0 0 1 
0 1 1 1 1 0 1 1 1 
0 1 0 1 1 0 1 0 0 
1 1 0 1 1 1 1 1 1 
1 0 1 1 1 0 1 1 1 
1 0 1 0 1 0 1 0 1 
1 1 1 0 1 1 1 0 1 
0 0 1 1 1 0 1 1 1 
1 1 1 0 1 1 1 0 0 

Complexity: 4
Time: 1946 seconds or 32.44 minutes or 0.54 hours