9 9
39
39 48 49 40 31 32 23 14 15 16 7 6 5 4 13 12 21 30 29 20 11 10 1 0 9 18 27 36 37 46 45 54 55 56 65 64 73 74 75 76 67 58 59 60 51 42 43 34 25 26 35 44 53 62 71 70 69 78 
1 1 0 0 1 1 1 1 0 
1 1 1 1 1 1 1 1 0 
1 0 1 1 0 1 0 1 1 
1 0 1 1 1 1 0 1 1 
1 1 0 2 1 0 1 1 1 
1 1 0 1 1 0 1 0 1 
1 1 1 0 1 1 1 0 1 
0 1 1 0 1 0 1 1 1 
0 1 1 1 1 0 1 0 0 

Complexity: 4
Time: 473 seconds or 7.89 minutes or 0.13 hours