11 8
67
67 66 65 57 56 64 72 73 81 82 83 75 76 84 85 86 87 79 71 70 69 61 60 59 51 50 49 41 40 32 24 25 33 34 35 43 44 45 53 54 55 47 39 38 30 29 28 20 19 18 10 9 8 0 1 2 3 4 5 13 14 22 23 15 7 
1 1 1 1 1 1 0 1 
1 1 1 0 0 1 1 1 
0 0 1 1 1 0 1 1 
1 1 0 0 1 1 1 0 
1 1 1 1 0 0 1 1 
1 1 0 1 1 1 0 1 
0 1 1 1 0 1 1 1 
1 1 0 1 1 1 0 0 
1 1 1 2 0 1 1 1 
1 1 0 1 1 0 0 1 
0 1 1 1 1 1 1 1 

Complexity: 4
Time: 383 seconds or 6.39 minutes or 0.11 hours