9 9
76
76 75 66 65 74 73 72 63 54 45 46 55 56 47 38 39 30 29 28 27 18 9 10 1 2 11 20 21 22 13 4 5 14 15 16 7 8 17 26 25 24 33 32 41 40 49 58 67 68 69 78 79 80 71 62 61 60 51 52 43 44 
0 1 1 0 1 1 0 1 1 
1 1 1 0 1 1 1 1 1 
1 0 1 1 1 0 1 1 1 
1 1 1 1 0 1 1 0 0 
0 0 1 1 1 1 0 1 1 
1 1 1 0 1 0 1 1 0 
1 1 1 0 1 0 1 1 1 
1 0 1 1 1 1 1 0 1 
1 1 1 1 2 0 1 1 1 

Complexity: 4
Time: 393 seconds or 6.55 minutes or 0.11 hours