9 9
21
21 20 29 28 19 18 9 10 1 2 3 4 13 14 15 24 25 16 7 8 17 26 35 44 53 52 43 42 41 32 31 40 39 48 49 50 59 60 69 70 71 80 79 78 77 76 67 66 75 74 73 72 63 54 55 56 47 46 45 36 
0 1 1 1 1 0 0 1 1 
1 1 0 0 1 1 1 1 1 
1 1 1 2 0 0 1 1 1 
0 1 1 0 1 1 0 0 1 
1 0 0 1 1 1 1 1 1 
1 1 1 1 1 1 0 1 1 
1 1 1 0 0 1 1 0 0 
1 0 0 1 1 0 1 1 1 
1 1 1 1 1 1 1 1 1 

Complexity: 4
Time: 297 seconds or 4.94 minutes or 0.08 hours