10 9
67
67 68 69 60 51 52 61 70 71 80 79 78 87 86 85 76 75 74 83 82 81 72 63 64 55 54 45 36 27 28 19 10 9 0 1 2 3 4 13 12 21 30 29 38 47 56 57 58 49 40 41 32 23 24 15 6 7 16 17 26 25 34 43 44 
1 1 1 1 1 0 1 1 0 
1 1 0 1 1 0 1 1 1 
0 1 0 1 0 1 1 1 1 
1 1 1 1 0 1 0 1 0 
1 0 1 0 1 1 0 1 1 
1 0 1 0 1 0 1 1 0 
1 1 1 1 1 0 1 1 0 
1 1 0 0 2 1 1 1 1 
1 0 1 1 1 0 1 1 1 
1 1 1 0 1 1 1 0 0 

Complexity: 4
Time: 1204 seconds or 20.07 minutes or 0.33 hours