10 8
43
43 51 50 49 41 33 32 40 48 56 64 72 73 74 66 58 59 60 61 69 68 76 77 78 79 71 63 55 54 53 45 37 36 35 27 26 25 17 16 8 9 1 2 3 11 19 20 21 13 5 6 7 15 14 22 30 38 39 
0 1 1 1 0 1 1 1 
1 1 0 1 0 1 1 1 
1 1 0 1 1 1 1 0 
0 1 1 1 0 0 1 0 
1 1 0 1 1 1 1 1 
1 1 0 2 0 1 0 0 
1 1 1 1 0 1 1 1 
1 0 1 1 1 1 0 1 
1 0 1 0 1 1 0 1 
1 1 1 0 1 1 1 1 

Complexity: 4
Time: 139 seconds or 2.32 minutes or 0.04 hours