11 8
61
61 53 54 46 45 44 43 51 50 58 59 67 68 69 70 62 63 71 79 87 86 85 84 76 75 83 82 81 80 72 73 65 57 49 48 40 32 33 34 26 18 17 16 8 0 1 2 3 4 5 13 12 11 19 27 28 29 37 38 39 31 30 22 14 15 7 
1 1 1 1 1 1 0 1 
1 0 0 1 1 1 1 1 
1 1 1 1 0 0 1 0 
0 0 1 1 1 1 1 1 
1 1 1 0 0 1 1 1 
1 0 0 1 1 1 1 0 
1 1 1 1 0 1 1 0 
0 1 1 1 0 2 1 1 
0 1 0 1 1 1 1 1 
1 1 0 1 1 0 0 1 
1 1 1 1 1 1 1 1 

Complexity: 4
Time: 1566 seconds or 26.1 minutes or 0.43 hours