10 8
34
34 35 36 28 29 30 38 39 31 23 15 14 13 5 4 12 20 19 11 3 2 1 0 8 16 17 18 26 25 33 32 40 48 56 64 65 57 49 41 42 43 51 59 60 61 69 68 67 66 74 75 76 77 78 70 71 63 55 54 53 45 
1 1 1 1 1 1 0 0 
1 0 0 1 1 1 1 1 
1 1 1 1 1 0 0 1 
0 1 1 0 1 1 1 1 
1 1 2 1 1 0 1 1 
1 1 1 1 0 1 0 0 
1 1 0 1 0 1 1 1 
1 1 0 1 1 1 0 1 
1 1 1 1 1 1 1 1 
0 0 1 1 1 1 1 0 

Complexity: 4
Time: 26 seconds or 0.44 minutes or 0.01 hours