10 9
58
58 67 68 69 78 79 80 89 88 87 86 77 76 75 84 83 74 73 72 63 64 65 56 47 46 45 36 37 28 27 18 9 0 1 2 11 20 21 30 31 40 39 48 49 50 51 52 61 62 53 44 43 42 33 24 23 22 13 4 5 6 7 16 25 26 
1 1 1 0 1 1 1 1 0 
1 0 1 0 1 0 0 1 0 
1 0 1 1 1 1 1 1 1 
1 1 0 1 1 0 1 0 0 
1 1 0 1 1 0 1 1 1 
1 1 1 1 1 1 1 1 1 
0 0 1 0 2 0 0 1 1 
1 1 1 0 1 1 1 0 0 
1 1 1 1 1 1 1 1 1 
0 0 1 1 0 1 1 1 1 

Complexity: 4
Time: 1841 seconds or 30.69 minutes or 0.51 hours