11 8
5
5 4 12 11 3 2 1 0 8 16 17 18 26 27 28 20 21 22 14 15 23 31 39 38 37 45 46 47 55 54 62 63 71 79 78 86 85 77 69 68 60 52 51 43 35 34 33 32 40 48 49 50 58 66 67 75 83 82 81 73 65 64 
1 1 1 1 1 2 0 0 
1 0 0 1 1 0 1 1 
1 1 1 0 1 1 1 1 
0 0 1 1 1 0 0 1 
1 1 1 1 0 1 1 1 
1 0 0 1 0 1 1 1 
1 1 1 1 1 0 1 1 
0 0 1 0 1 0 1 1 
1 1 1 1 1 1 0 1 
0 1 0 1 0 1 1 1 
0 1 1 1 0 1 1 0 

Complexity: 4
Time: 783 seconds or 13.04 minutes or 0.22 hours