9 9
29
29 20 11 12 3 4 5 14 15 24 25 16 7 8 17 26 35 44 43 42 51 60 61 62 71 80 79 78 69 68 67 58 59 50 41 32 31 22 21 30 39 48 47 46 55 64 65 66 75 74 73 72 63 54 45 36 27 28 19 10 1 0 
1 1 0 1 1 1 0 1 1 
0 1 1 1 0 1 1 1 1 
0 1 1 1 1 0 1 1 1 
1 1 2 1 1 1 0 0 1 
1 0 0 1 0 1 1 1 1 
1 1 1 1 0 1 1 0 0 
1 1 0 0 1 1 1 1 1 
1 1 1 1 1 1 1 0 1 
1 1 1 1 0 0 1 1 1 

Complexity: 4
Time: 90 seconds or 1.5 minutes or 0.03 hours