11 8
17
17 16 24 25 33 41 40 48 56 64 72 80 81 73 65 66 58 59 60 52 51 50 42 34 35 36 28 27 19 11 10 9 1 2 3 4 5 6 14 13 21 22 23 31 39 38 37 45 53 54 55 63 71 70 69 77 76 75 83 84 85 86 87 
0 1 1 1 1 1 1 0 
0 1 1 1 0 1 1 0 
1 2 0 1 0 1 1 1 
1 1 0 1 1 0 0 1 
0 1 1 1 1 1 1 1 
1 1 1 0 0 1 0 0 
1 0 1 1 1 1 1 1 
1 0 1 1 1 0 0 1 
1 1 1 0 0 1 1 1 
1 1 0 1 1 1 0 0 
1 1 0 1 1 1 1 1 

Complexity: 4
Time: 1972 seconds or 32.87 minutes or 0.55 hours