9 9
70
70 61 62 53 44 43 34 35 26 17 8 7 16 15 24 23 14 5 4 3 2 1 0 9 18 27 36 45 54 63 64 73 74 65 56 57 48 47 38 37 28 19 10 11 12 21 30 31 40 41 42 51 50 59 68 67 76 77 78 79 80 
1 1 1 1 1 1 0 1 1 
1 1 1 1 0 1 1 1 1 
1 1 0 1 0 1 1 0 1 
1 1 0 1 1 0 0 1 1 
1 1 1 0 1 1 1 1 1 
1 0 1 1 0 1 1 0 1 
1 0 1 1 0 1 0 1 1 
1 1 1 0 1 1 0 2 0 
0 1 1 0 1 1 1 1 1 

Complexity: 4
Time: 142 seconds or 2.36 minutes or 0.04 hours