10 9
87
87 88 79 80 71 70 61 60 51 52 43 44 35 26 25 24 33 42 41 50 49 48 57 66 67 68 77 86 85 76 75 74 73 82 81 72 63 64 55 46 47 38 37 36 27 28 19 18 9 0 1 2 11 12 21 30 31 22 13 4 5 14 15 6 7 8 
1 1 1 0 1 1 1 1 1 
1 0 1 1 1 1 1 0 0 
1 1 0 1 1 0 1 1 1 
1 1 0 1 1 0 1 0 1 
1 1 1 0 0 1 1 1 1 
0 1 1 1 1 1 1 1 0 
0 1 0 1 0 0 1 1 0 
1 1 0 1 1 1 0 1 1 
1 1 1 1 1 1 0 1 1 
1 1 0 0 1 1 2 1 0 

Complexity: 4
Time: 678 seconds or 11.3 minutes or 0.19 hours