9 9
20
20 21 22 13 4 5 6 7 8 17 26 25 16 15 24 33 32 31 30 39 40 49 48 47 56 57 66 67 68 59 60 51 42 43 44 53 62 71 70 79 78 77 76 75 74 73 64 63 54 45 46 37 36 27 28 19 10 11 2 1 0 
1 1 1 0 1 1 1 1 1 
0 1 1 0 1 0 1 1 1 
0 1 2 1 1 0 1 1 1 
1 1 0 1 1 1 1 0 0 
1 1 0 1 1 0 1 1 1 
1 1 1 1 1 0 1 0 1 
1 0 1 1 0 1 1 0 1 
1 1 0 1 1 1 0 1 1 
0 1 1 1 1 1 1 1 0 

Complexity: 4
Time: 242 seconds or 4.04 minutes or 0.07 hours