11 8
45
45 44 52 53 54 55 63 62 70 69 68 67 59 58 50 42 34 35 36 28 29 21 22 30 38 39 31 23 15 14 6 5 4 12 11 19 18 10 9 1 0 8 16 24 25 33 32 40 48 49 57 65 64 72 80 81 82 74 75 76 84 85 86 78 79 
1 1 0 0 1 1 1 0 
1 1 1 1 1 0 1 1 
1 0 1 1 0 1 1 1 
1 1 0 0 1 1 1 1 
1 1 1 1 1 0 1 1 
1 0 1 0 1 2 0 0 
1 1 1 0 1 1 1 1 
0 1 1 1 0 0 1 1 
1 1 0 1 1 1 1 0 
1 0 1 1 1 0 1 1 
1 1 1 0 1 1 1 0 

Complexity: 4
Time: 893 seconds or 14.89 minutes or 0.25 hours