10 9
89
89 88 79 80 71 62 61 52 43 42 33 24 25 34 35 26 17 8 7 6 5 14 23 22 31 40 39 30 21 20 11 12 3 2 1 0 9 18 27 28 37 36 45 54 63 64 65 56 47 48 57 58 49 50 59 60 69 68 77 86 85 76 75 74 73 82 81 
1 1 1 1 0 1 1 1 1 
1 0 1 1 0 1 0 0 1 
1 0 1 1 1 1 1 1 1 
1 1 0 1 1 0 1 1 1 
1 1 0 1 1 0 1 1 0 
1 0 1 1 1 1 0 1 0 
1 0 1 1 1 1 1 1 1 
1 1 1 0 0 1 1 0 1 
0 1 1 1 1 1 0 1 1 
1 1 0 0 1 1 0 1 2 

Complexity: 4
Time: 8125 seconds or 135.42 minutes or 2.26 hours