11 8
28
28 36 37 45 53 52 44 43 42 34 26 18 19 11 3 4 5 6 7 15 14 13 21 22 30 31 39 47 55 54 62 70 71 79 78 86 85 77 69 68 76 75 67 59 58 66 74 82 81 80 72 64 56 57 49 41 33 32 24 16 17 9 1 
0 1 0 1 1 1 1 1 
0 1 0 1 0 1 1 1 
1 1 1 1 0 1 1 0 
1 0 1 0 2 0 1 1 
1 1 1 0 1 1 0 1 
0 1 1 1 1 1 0 1 
0 1 0 0 1 1 1 1 
1 1 1 1 0 0 1 0 
1 0 1 1 1 1 1 1 
1 0 1 1 1 1 1 1 
1 1 1 0 0 1 1 0 

Complexity: 4
Time: 2547 seconds or 42.45 minutes or 0.71 hours