9 9
35
35 26 17 8 7 6 5 14 13 12 21 30 29 38 39 48 49 40 41 32 23 24 25 34 43 44 53 62 71 80 79 70 61 52 51 60 59 68 77 76 67 66 75 74 73 64 65 56 55 54 45 46 37 36 27 18 19 10 11 2 1 0 
1 1 1 0 0 1 1 1 1 
0 1 1 1 1 1 0 0 1 
1 1 0 1 0 1 1 1 1 
1 0 1 1 0 1 0 1 2 
1 1 1 1 1 1 0 1 1 
1 1 0 1 1 0 1 1 1 
1 1 1 0 0 1 1 1 1 
0 1 1 1 1 1 0 1 1 
0 1 1 1 1 1 0 1 1 

Complexity: 4
Time: 327 seconds or 5.45 minutes or 0.09 hours