10 8
35
35 27 28 36 37 45 53 54 55 47 39 31 30 22 23 15 7 6 5 13 21 20 12 11 3 2 1 0 8 9 10 18 26 25 24 32 40 48 49 41 42 43 51 59 58 57 65 64 72 73 74 75 76 68 60 61 69 70 71 79 
1 1 1 1 0 1 1 1 
1 1 1 1 1 1 0 1 
0 0 1 0 1 1 1 1 
1 1 1 1 1 0 1 1 
1 0 0 2 1 1 0 1 
1 1 1 1 0 1 0 1 
1 1 0 1 0 1 1 1 
0 1 1 1 1 1 0 0 
1 1 0 0 1 1 1 1 
1 1 1 1 1 0 0 1 

Complexity: 4
Time: 189 seconds or 3.15 minutes or 0.05 hours