11 8
85
85 86 87 79 71 70 78 77 76 84 83 82 81 73 72 64 56 57 49 41 33 32 24 16 17 9 1 2 3 4 5 13 12 20 19 18 26 34 35 36 44 52 51 50 58 66 67 59 60 61 53 54 55 47 46 38 37 29 30 22 23 15 7 
0 1 1 1 1 1 0 1 
0 1 0 0 1 1 0 1 
1 1 1 1 1 0 1 1 
1 0 1 0 0 1 1 0 
1 1 1 1 1 1 1 0 
0 1 0 0 1 0 1 1 
0 1 1 1 1 1 1 1 
1 1 1 1 1 1 0 0 
1 0 1 1 0 0 1 1 
1 1 0 0 1 1 1 1 
0 1 1 1 1 2 1 1 

Complexity: 4
Time: 1415 seconds or 23.59 minutes or 0.39 hours