10 9
41
41 42 51 60 59 58 49 48 47 38 29 30 31 22 13 14 5 4 3 12 11 2 1 0 9 10 19 28 37 36 45 54 55 64 73 72 81 82 83 74 65 66 67 76 85 86 77 78 87 88 79 70 71 62 53 52 43 34 33 24 25 26 17 16 7 
1 1 1 1 1 1 0 1 0 
1 1 1 1 1 1 0 1 1 
0 1 0 0 1 0 1 1 1 
0 1 1 1 1 0 1 1 0 
1 1 1 0 0 2 1 1 0 
1 0 1 1 1 0 1 1 1 
1 1 0 0 1 1 1 0 1 
0 1 1 1 1 0 0 1 1 
1 1 1 0 1 1 1 1 0 
1 1 1 0 1 1 1 1 0 

Complexity: 4
Time: 390 seconds or 6.5 minutes or 0.11 hours