11 8
33
33 25 26 34 42 43 35 36 44 52 53 54 55 47 39 38 37 29 30 31 23 15 14 6 5 13 12 20 19 11 10 2 1 9 8 16 24 32 40 41 49 57 58 59 67 75 76 77 69 61 62 63 71 79 87 86 85 84 83 82 74 73 81 80 72 64 
0 1 1 0 0 1 1 0 
1 1 1 1 1 1 1 1 
1 0 0 1 1 0 0 1 
1 1 1 0 0 1 1 1 
1 2 1 1 1 1 1 1 
1 1 1 1 1 0 0 1 
0 1 0 0 1 1 1 1 
0 1 1 1 0 1 1 1 
1 0 0 1 0 1 0 1 
1 1 1 1 1 1 0 1 
1 1 1 1 1 1 1 1 

Complexity: 4
Time: 2551 seconds or 42.52 minutes or 0.71 hours