11 8
49
49 41 42 34 26 27 35 36 28 20 12 11 10 2 1 0 8 9 17 16 24 32 40 48 56 64 72 80 81 73 74 66 58 59 51 52 60 61 69 77 76 75 83 84 85 86 78 79 71 63 62 54 46 45 37 38 39 31 30 22 14 13 5 6 7 
1 1 1 0 0 1 1 1 
1 1 1 1 1 1 1 0 
1 1 0 0 1 0 1 0 
1 0 1 1 1 0 1 1 
1 0 1 1 1 1 1 1 
1 1 1 0 0 1 1 0 
1 2 0 1 1 0 1 0 
1 0 1 1 1 1 1 1 
1 0 1 0 0 1 0 1 
1 1 1 1 1 1 1 1 
1 1 0 1 1 1 1 0 

Complexity: 4
Time: 979 seconds or 16.32 minutes or 0.27 hours