9 9
53
53 62 71 70 61 52 51 50 49 40 39 30 21 22 23 32 33 34 43 44 35 26 17 16 7 6 15 14 5 4 3 2 11 10 1 0 9 18 27 28 29 38 47 46 45 54 55 64 63 72 73 74 75 66 57 58 59 68 77 78 
1 1 1 1 1 1 1 1 0 
1 1 1 0 0 1 1 1 1 
1 0 0 1 1 1 0 0 1 
1 1 1 1 0 1 1 1 1 
0 0 1 1 1 0 0 1 1 
1 1 1 0 1 1 1 1 2 
1 1 0 1 1 1 0 1 1 
1 1 0 1 0 1 0 1 1 
1 1 1 1 0 1 1 0 0 

Complexity: 4
Time: 1266 seconds or 21.09 minutes or 0.35 hours