10 9
2
2 11 10 9 18 19 28 27 36 45 46 55 56 47 38 39 30 21 12 13 22 23 14 5 6 7 16 17 26 25 24 33 34 43 44 53 62 71 70 79 88 87 86 77 68 59 60 51 50 41 40 49 58 67 66 75 84 83 82 73 64 63 
0 0 2 0 0 1 1 1 0 
1 1 1 1 1 1 0 1 1 
1 1 0 1 1 1 1 1 1 
1 1 0 1 0 0 1 1 0 
1 0 1 1 1 1 0 1 1 
1 1 1 0 1 1 1 0 1 
0 1 1 0 1 1 1 0 1 
1 1 0 1 1 1 0 1 1 
0 1 0 1 0 1 0 1 0 
0 1 1 1 0 1 1 1 0 

Complexity: 4
Time: 2756 seconds or 45.93 minutes or 0.77 hours