11 8
35
35 27 28 20 19 18 10 2 3 4 5 13 14 15 23 22 30 38 37 36 44 43 42 50 51 59 67 68 69 61 53 54 46 47 55 63 71 79 78 86 85 77 76 75 74 82 81 80 72 64 65 57 56 48 40 32 33 25 17 16 8 0 
1 0 1 1 1 1 0 0 
1 0 1 0 0 1 1 1 
1 1 1 1 1 0 1 1 
0 1 0 1 1 0 1 0 
1 1 0 2 1 1 1 0 
1 0 1 1 1 0 1 1 
1 0 1 1 0 1 1 1 
1 1 0 1 0 1 0 1 
1 1 0 1 1 1 0 1 
1 0 1 1 1 1 1 1 
1 1 1 0 0 1 1 0 

Complexity: 4
Time: 419 seconds or 6.98 minutes or 0.12 hours