10 8
76
76 75 74 73 65 66 58 57 56 48 49 41 33 32 24 16 17 9 1 2 3 11 10 18 26 34 35 43 51 59 60 68 69 77 78 79 71 63 62 54 53 45 37 36 28 20 21 13 5 6 14 15 23 31 30 38 39 47 
0 1 1 1 0 1 1 0 
0 1 1 1 0 1 1 1 
1 1 1 0 1 1 0 1 
1 0 1 0 1 0 1 1 
1 1 1 1 1 1 1 1 
0 1 0 1 0 1 0 1 
1 1 0 1 0 1 1 0 
1 1 1 1 1 0 1 1 
0 1 1 0 1 1 0 1 
0 1 1 1 2 1 1 1 

Complexity: 4
Time: 256 seconds or 4.26 minutes or 0.07 hours