9 9
7
7 8 17 26 35 44 43 52 53 62 61 60 69 70 79 78 77 76 75 66 65 74 73 64 55 54 45 36 27 28 37 38 47 48 49 58 59 50 41 42 33 34 25 16 15 6 5 4 13 14 23 22 31 30 21 20 19 10 11 2 1 0 
1 1 1 0 1 1 1 2 1 
0 1 1 0 1 1 1 1 1 
0 1 1 1 1 1 0 1 1 
1 1 0 1 1 0 1 1 1 
1 1 1 0 0 1 1 1 1 
1 0 1 1 1 1 0 1 1 
1 1 0 0 1 1 1 1 1 
0 1 1 1 0 0 1 1 0 
0 1 1 1 1 1 1 1 0 

Complexity: 4
Time: 298 seconds or 4.97 minutes or 0.08 hours