9 9
20
20 21 12 3 2 1 0 9 18 19 28 27 36 45 46 37 38 39 40 49 50 41 42 33 32 31 22 13 14 15 6 7 8 17 16 25 26 35 44 43 52 61 60 69 70 71 80 79 78 77 68 67 76 75 66 57 56 65 74 73 64 63 
1 1 1 1 0 0 1 1 1 
1 0 0 1 1 1 1 1 1 
1 1 2 1 1 0 0 1 1 
1 1 0 0 1 1 1 0 1 
1 1 1 1 1 1 1 1 1 
1 1 0 0 1 1 0 1 0 
0 0 1 1 0 0 1 1 0 
1 1 1 1 1 1 1 1 1 
0 1 1 1 1 1 1 1 1 

Complexity: 4
Time: 362 seconds or 6.04 minutes or 0.1 hours