9 9
75
75 74 65 64 63 54 45 36 37 38 47 56 57 58 67 76 77 78 69 60 61 70 79 80 71 62 53 44 35 26 25 34 33 32 41 42 51 50 49 40 39 30 29 28 19 10 9 0 1 2 11 12 21 22 13 4 5 14 15 6 7 8 
1 1 1 0 1 1 1 1 1 
1 1 1 1 1 1 1 0 0 
0 1 0 1 1 0 0 1 1 
0 1 1 1 0 1 1 1 1 
1 1 1 1 1 1 1 0 1 
1 0 1 0 1 1 1 0 1 
1 0 1 1 1 0 1 1 1 
1 1 1 0 1 0 1 1 1 
0 0 1 2 1 1 1 1 1 

Complexity: 4
Time: 119 seconds or 1.98 minutes or 0.03 hours