10 9
70
70 61 60 59 50 41 40 31 22 21 20 19 28 27 18 9 10 1 2 11 12 13 14 5 6 7 8 17 26 25 24 33 34 43 52 53 62 71 80 79 78 87 86 77 68 67 76 75 74 83 82 81 72 73 64 55 56 57 48 39 38 47 46 45 
0 1 1 0 0 1 1 1 1 
1 1 1 1 1 1 0 0 1 
1 1 1 1 1 0 1 1 1 
1 1 0 0 1 0 1 1 0 
0 0 1 1 1 1 0 1 0 
1 1 1 1 0 1 0 1 1 
0 1 1 1 0 1 1 1 1 
0 1 0 0 1 1 0 2 1 
1 1 1 1 1 1 1 1 1 
1 1 1 0 0 1 1 0 0 

Complexity: 4
Time: 708 seconds or 11.8 minutes or 0.2 hours