9 9
45
45 54 55 64 73 74 75 76 67 68 77 78 79 80 71 62 61 60 51 50 49 58 57 56 47 46 37 28 27 18 9 10 19 20 29 30 39 40 31 22 23 24 33 42 43 44 35 26 17 16 7 6 5 4 13 12 3 2 
0 0 1 1 1 1 1 1 0 
1 1 0 1 1 0 0 1 1 
1 1 1 0 1 1 1 0 1 
1 1 1 1 1 0 1 0 1 
0 1 0 1 1 0 1 1 1 
2 1 1 0 1 1 1 0 0 
1 1 1 1 1 0 1 1 1 
0 1 0 0 1 1 0 0 1 
0 1 1 1 1 1 1 1 1 

Complexity: 4
Time: 115 seconds or 1.92 minutes or 0.03 hours