10 8
37
37 45 44 43 51 50 58 57 56 64 65 73 74 75 67 68 60 61 69 70 78 79 71 63 55 54 46 47 39 31 30 22 14 15 7 6 5 13 21 20 28 27 26 34 42 41 40 32 24 16 17 9 10 11 3 2 1 0 
1 1 1 1 0 1 1 1 
0 1 1 1 0 1 1 1 
1 1 0 0 1 1 1 0 
1 0 1 1 1 0 1 1 
1 0 1 0 0 2 0 1 
1 1 1 1 1 1 1 1 
0 0 1 1 0 0 1 1 
1 1 1 0 1 1 0 1 
1 1 0 1 1 1 1 1 
0 1 1 1 0 0 1 1 

Complexity: 4
Time: 259 seconds or 4.32 minutes or 0.07 hours