9 9
3
3 4 13 12 21 20 11 2 1 10 9 18 19 28 37 36 45 54 63 64 73 74 65 66 75 76 77 78 69 70 71 62 61 52 53 44 35 34 33 42 41 50 59 58 57 56 47 38 39 40 31 32 23 24 15 6 7 16 17 
0 1 1 2 1 0 1 1 0 
1 1 1 1 1 0 1 1 1 
1 1 1 1 0 1 1 0 0 
0 1 0 0 1 1 1 1 1 
1 1 1 1 1 1 1 0 1 
1 0 1 0 0 1 0 1 1 
1 0 1 1 1 1 0 1 1 
1 1 1 1 0 0 1 1 1 
0 1 1 1 1 1 1 0 0 

Complexity: 4
Time: 743 seconds or 12.38 minutes or 0.21 hours