11 8
19
19 20 28 29 30 38 46 47 39 31 23 15 7 6 14 13 12 4 3 2 10 9 1 0 8 16 24 25 26 27 35 34 33 41 49 48 56 64 72 73 81 82 83 75 76 68 67 66 58 50 51 52 44 45 53 61 62 63 71 79 78 77 85 
1 1 1 1 1 0 1 1 
1 1 1 0 1 1 1 1 
1 0 0 2 1 0 0 1 
1 1 1 1 1 1 1 1 
0 1 1 1 0 0 1 1 
0 1 0 0 1 1 1 1 
1 1 1 1 1 1 0 0 
1 0 1 0 0 1 1 1 
1 0 1 1 1 0 0 1 
1 1 0 1 1 1 1 1 
0 1 1 1 0 1 0 0 

Complexity: 4
Time: 167 seconds or 2.78 minutes or 0.05 hours