10 9
81
81 72 73 82 83 84 85 76 67 66 65 56 47 46 55 54 45 36 37 28 27 18 9 0 1 10 19 20 11 12 13 4 5 6 7 16 15 14 23 32 31 30 39 40 49 58 59 60 51 42 43 34 25 26 35 44 53 62 71 70 79 78 77 86 87 88 89 
1 1 0 0 1 1 1 1 0 
1 1 1 1 1 1 1 1 0 
1 1 1 0 0 1 0 1 1 
1 1 0 1 1 1 0 1 1 
1 1 0 1 1 0 1 1 1 
1 1 1 0 1 0 1 0 1 
1 1 1 0 1 1 1 0 1 
0 0 1 1 1 0 0 1 1 
1 1 0 0 1 1 1 1 0 
2 1 1 1 1 1 1 1 1 

Complexity: 4
Time: 614 seconds or 10.23 minutes or 0.17 hours