11 8
49
49 48 40 41 33 34 35 27 28 36 37 45 44 43 51 59 58 57 56 64 65 73 81 82 83 75 67 68 76 84 85 86 87 79 78 70 62 61 53 54 55 47 39 31 30 22 21 13 14 15 7 6 5 4 3 11 19 18 17 25 24 16 8 9 1 
0 1 0 1 1 1 1 1 
1 1 0 1 0 1 1 1 
1 1 1 1 0 1 1 0 
1 1 0 1 1 0 1 1 
0 1 1 1 1 1 0 1 
1 1 0 1 1 1 0 1 
1 2 0 1 0 1 1 1 
1 1 1 1 0 1 1 0 
1 1 0 1 1 0 1 0 
0 1 0 1 1 0 1 1 
0 1 1 1 1 1 1 1 

Complexity: 4
Time: 909 seconds or 15.16 minutes or 0.25 hours