10 8
59
59 51 52 60 61 69 68 76 77 78 79 71 63 55 54 46 47 39 31 23 22 14 6 5 4 3 11 10 2 1 0 8 16 17 25 26 27 19 20 21 29 37 36 44 43 42 41 33 32 40 48 49 57 65 66 74 73 72 
1 1 1 1 1 1 1 0 
1 0 1 1 0 0 1 0 
1 1 0 1 1 1 1 1 
0 1 1 1 0 1 0 1 
1 1 0 0 1 1 0 1 
1 1 1 1 1 0 1 1 
1 1 0 1 1 0 1 1 
0 1 0 2 1 1 0 1 
0 1 1 0 1 1 0 1 
1 1 1 0 1 1 1 1 

Complexity: 4
Time: 290 seconds or 4.83 minutes or 0.08 hours