10 8
65
65 57 58 50 42 43 35 27 28 36 37 29 21 13 14 6 7 15 23 31 39 38 46 54 53 52 60 61 62 63 71 70 78 77 76 75 67 66 74 73 72 64 56 48 40 32 33 25 17 18 10 11 12 4 3 2 1 9 8 
0 1 1 1 1 0 1 1 
1 1 1 1 1 1 1 1 
0 1 1 0 0 1 0 1 
0 1 0 1 1 1 0 1 
1 1 0 1 1 1 1 1 
1 0 1 1 0 0 1 0 
1 0 1 0 1 1 1 0 
1 1 1 0 1 1 1 1 
1 2 1 1 0 0 1 1 
1 1 1 1 1 1 1 0 

Complexity: 4
Time: 135 seconds or 2.25 minutes or 0.04 hours