11 8
74
74 73 72 80 81 82 83 84 85 86 78 77 69 70 71 63 62 54 46 45 44 36 35 43 51 52 60 68 67 66 58 57 56 48 49 41 40 32 33 34 26 25 17 9 8 0 1 2 3 4 12 11 19 20 21 29 30 38 39 31 23 22 14 6 
1 1 1 1 1 0 1 0 
1 1 0 1 1 0 1 0 
0 1 0 1 1 1 1 1 
0 1 1 0 0 1 1 1 
1 1 1 1 1 0 1 1 
1 1 0 1 1 1 1 0 
1 1 0 1 1 0 1 0 
1 1 1 0 1 0 1 1 
0 0 1 1 1 1 1 1 
1 1 2 0 0 1 1 0 
1 1 1 1 1 1 1 0 

Complexity: 4
Time: 1690 seconds or 28.17 minutes or 0.47 hours