9 9
0
0 1 2 3 4 5 14 13 12 21 20 11 10 9 18 19 28 27 36 45 46 55 54 63 64 65 74 75 76 77 68 69 60 51 50 59 58 57 48 47 38 39 40 31 32 33 24 25 16 7 8 17 26 35 44 43 52 53 62 71 70 79 
2 1 1 1 1 1 0 1 1 
1 1 1 1 1 1 0 1 1 
1 1 1 1 0 0 1 1 1 
1 1 0 0 1 1 1 0 1 
1 0 1 1 1 0 0 1 1 
1 1 1 1 0 1 1 1 1 
1 1 0 1 1 1 1 0 1 
1 1 1 0 0 1 1 1 1 
0 0 1 1 1 1 0 1 0 

Complexity: 4
Time: 101 seconds or 1.69 minutes or 0.03 hours