9 9
39
39 38 29 30 21 12 13 4 3 2 1 10 19 18 27 36 45 46 55 56 57 66 65 64 63 72 73 74 75 76 77 68 59 60 69 78 79 70 71 62 53 44 35 26 25 34 43 42 51 50 49 40 31 32 23 14 15 16 7 8 
0 1 1 1 1 0 0 1 1 
0 1 0 1 1 1 1 1 0 
1 1 0 1 0 1 0 1 1 
1 0 1 1 1 1 0 1 1 
1 0 1 2 1 0 1 1 1 
1 1 0 0 1 1 1 0 1 
0 1 1 1 0 1 1 0 1 
1 1 1 1 0 1 1 1 1 
1 1 1 1 1 1 1 1 0 

Complexity: 4
Time: 31 seconds or 0.51 minutes or 0.01 hours