10 9
28
28 29 38 47 48 57 66 67 76 77 78 87 88 79 80 71 70 61 60 59 50 49 40 31 32 33 42 43 52 53 44 35 26 25 24 15 16 7 6 5 4 13 22 21 12 3 2 1 0 9 10 19 18 27 36 45 54 55 64 63 72 81 82 73 74 83 84 
1 1 1 1 1 1 1 1 0 
1 1 0 1 1 0 1 1 0 
1 1 0 1 1 0 1 1 1 
1 2 1 0 1 1 1 0 1 
1 0 1 0 1 0 1 1 1 
1 0 1 1 1 1 0 1 1 
1 1 0 1 0 1 1 1 0 
1 1 0 1 1 0 0 1 1 
1 1 1 0 1 1 1 1 1 
1 1 1 1 0 0 1 1 0 

Complexity: 4
Time: 799 seconds or 13.31 minutes or 0.22 hours