9 9
43
43 34 35 26 17 8 7 6 15 24 23 32 41 50 51 52 53 62 71 70 79 78 69 68 59 58 67 66 75 74 73 64 63 54 45 36 27 28 37 46 47 56 57 48 39 30 31 22 13 4 3 2 11 20 19 10 9 
0 0 1 1 1 0 1 1 1 
1 1 1 0 1 0 1 0 1 
0 1 1 0 1 1 1 0 1 
1 1 0 1 1 1 0 1 1 
1 1 0 1 0 1 0 2 0 
1 1 1 1 0 1 1 1 1 
1 0 1 1 1 1 0 0 1 
1 1 0 1 1 1 1 1 1 
0 1 1 1 0 0 1 1 0 

Complexity: 4
Time: 15 seconds or 0.25 minutes or 0 hours