10 9
69
69 78 87 88 79 80 71 70 61 60 59 68 67 66 75 76 85 84 83 82 81 72 63 64 65 56 55 54 45 46 37 36 27 18 9 10 1 2 3 4 13 12 11 20 29 30 39 48 49 40 31 32 23 24 15 6 7 8 17 26 25 34 43 42 51 52 53 
0 1 1 1 1 0 1 1 1 
1 1 1 1 1 0 1 0 1 
1 0 1 0 0 1 1 1 1 
1 0 1 1 1 1 0 1 0 
1 1 0 1 1 0 1 1 0 
1 1 0 1 1 0 1 1 1 
1 1 1 0 0 1 1 1 0 
1 1 1 1 1 1 2 1 1 
1 0 0 1 1 0 1 1 1 
1 1 1 1 1 0 1 1 0 

Complexity: 4
Time: 1217 seconds or 20.29 minutes or 0.34 hours