10 8
59
59 67 66 65 57 56 64 72 73 74 75 76 77 69 61 60 52 51 50 42 34 33 41 40 32 24 25 17 16 8 9 1 2 10 11 12 4 5 6 7 15 23 31 30 22 21 20 19 27 35 36 37 45 46 47 55 54 62 70 71 79 
0 1 1 0 1 1 1 1 
1 1 1 1 1 0 0 1 
1 1 0 1 1 1 1 1 
1 1 0 1 0 0 1 1 
1 1 1 1 1 1 0 0 
1 1 1 0 0 1 1 1 
0 0 1 1 1 0 1 1 
1 1 0 2 1 1 1 0 
1 1 1 1 0 1 1 1 
1 1 1 1 1 1 0 1 

Complexity: 4
Time: 837 seconds or 13.96 minutes or 0.23 hours