10 8
54
54 53 45 44 43 35 36 28 20 21 13 5 4 12 11 10 9 1 0 8 16 17 18 26 25 33 41 40 48 49 50 58 57 56 64 72 73 74 75 67 59 60 61 69 77 78 79 71 63 55 47 39 38 30 22 23 15 7 
1 1 0 0 1 1 0 1 
1 1 1 1 1 1 0 1 
1 1 1 0 1 1 1 1 
0 1 1 0 1 0 1 0 
0 1 0 1 1 0 1 1 
1 1 0 1 1 1 0 1 
1 1 1 0 0 1 2 1 
1 1 1 1 1 1 0 1 
1 0 0 1 0 1 0 1 
1 1 1 1 0 1 1 1 

Complexity: 4
Time: 297 seconds or 4.95 minutes or 0.08 hours