10 9
73
73 72 81 82 83 74 65 66 75 84 85 86 77 68 59 58 57 48 47 46 55 54 45 36 37 28 19 10 9 0 1 2 3 4 13 22 21 20 29 30 31 40 41 32 23 24 15 6 7 16 17 26 35 34 43 44 53 52 51 60 69 70 71 80 79 88 
1 1 1 1 1 0 1 1 0 
1 1 0 0 1 0 1 1 1 
0 1 1 1 1 1 1 0 1 
0 1 1 1 1 1 0 1 1 
1 1 0 0 1 1 0 1 1 
1 1 1 1 0 0 1 1 1 
1 1 0 1 1 1 1 0 0 
0 0 1 1 0 1 1 1 1 
1 2 1 1 0 1 0 1 1 
1 1 1 1 1 1 0 1 0 

Complexity: 4
Time: 1545 seconds or 25.75 minutes or 0.43 hours