10 8
42
42 34 35 43 51 50 58 59 60 68 69 70 78 77 76 75 74 73 65 64 56 48 40 41 33 25 24 16 8 0 1 2 3 11 10 18 19 20 28 36 37 45 53 54 62 63 55 47 39 31 30 22 14 13 5 6 7 
1 1 1 1 0 1 1 1 
1 0 1 1 0 1 1 0 
1 0 1 1 1 0 1 0 
1 1 0 0 1 0 1 1 
0 1 1 1 1 1 0 1 
1 1 2 1 0 1 0 1 
1 0 1 1 0 1 1 1 
1 0 1 1 1 0 1 1 
1 1 0 0 1 1 1 0 
0 1 1 1 1 1 1 0 

Complexity: 4
Time: 502 seconds or 8.36 minutes or 0.14 hours