10 8
8
8 0 1 2 3 11 12 13 5 6 7 15 14 22 23 31 39 47 46 45 37 29 28 27 19 18 17 16 24 32 33 34 42 43 44 52 60 59 58 50 49 48 56 64 65 73 74 75 76 68 69 70 62 54 55 63 71 79 
1 1 1 1 0 1 1 1 
2 0 0 1 1 1 1 1 
1 1 1 1 0 0 1 1 
1 0 0 1 1 1 0 1 
1 1 1 0 0 1 0 1 
0 0 1 1 1 1 1 1 
1 1 1 0 1 0 1 1 
1 0 1 1 1 0 1 1 
1 1 0 0 1 1 1 1 
0 1 1 1 1 0 0 1 

Complexity: 4
Time: 85 seconds or 1.42 minutes or 0.02 hours