9 9
51
51 52 61 62 71 70 69 78 77 68 59 58 67 76 75 66 65 64 73 72 63 54 55 46 45 36 27 18 19 10 9 0 1 2 3 12 21 20 29 38 47 48 49 40 41 32 31 22 23 14 5 6 7 16 17 26 25 24 33 34 43 44 
1 1 1 1 0 1 1 1 0 
1 1 0 1 0 1 0 1 1 
1 1 1 1 1 1 1 1 1 
1 0 1 0 1 1 1 1 0 
1 0 1 0 1 1 0 1 1 
1 1 1 1 1 0 2 1 0 
1 1 0 0 1 1 0 1 1 
1 1 1 1 1 1 1 1 1 
1 1 0 1 1 1 1 0 0 

Complexity: 4
Time: 131 seconds or 2.18 minutes or 0.04 hours