11 8
58
58 59 67 75 74 82 81 73 72 64 56 57 49 48 40 32 33 41 42 43 44 52 53 61 69 77 76 84 85 86 78 79 71 63 55 54 46 47 39 31 23 15 14 22 21 29 37 36 28 27 26 18 17 16 8 0 1 2 3 11 12 13 5 
1 1 1 1 0 1 0 0 
1 0 0 1 1 1 1 1 
1 1 1 0 0 1 1 1 
0 0 1 1 1 1 0 1 
1 1 0 0 1 1 0 1 
1 1 1 1 1 0 1 1 
1 1 0 0 1 1 1 1 
1 1 2 1 0 1 0 1 
1 0 0 1 0 1 0 1 
1 1 1 1 1 1 1 1 
0 1 1 0 1 1 1 0 

Complexity: 4
Time: 291 seconds or 4.85 minutes or 0.08 hours