9 9
67
67 66 75 74 73 72 63 54 55 56 47 46 37 28 27 18 9 0 1 2 3 12 11 20 21 30 39 48 49 50 59 68 69 78 79 70 71 62 53 52 51 42 41 32 31 22 13 4 5 6 15 24 25 34 35 26 17 8 
1 1 1 1 1 1 1 0 1 
1 0 1 1 1 0 1 0 1 
1 0 1 1 1 0 1 1 1 
1 1 0 1 1 1 0 1 1 
0 1 0 1 0 1 1 0 0 
0 1 1 1 1 1 1 1 1 
1 1 1 0 0 1 0 0 1 
1 0 0 1 2 1 1 1 1 
1 1 1 1 0 0 1 1 0 

Complexity: 4
Time: 258 seconds or 4.3 minutes or 0.07 hours