11 8
21
21 20 12 11 10 9 1 2 3 4 5 6 7 15 23 22 30 31 39 47 55 54 62 70 69 77 78 79 87 86 85 84 83 75 67 66 74 82 81 80 72 64 56 57 58 59 60 52 51 50 42 41 40 32 24 16 17 25 26 27 35 36 37 45 
0 1 1 1 1 1 1 1 
0 1 1 1 1 0 0 1 
1 1 0 0 1 2 1 1 
1 1 1 1 0 0 1 1 
1 0 0 1 1 1 0 1 
1 1 1 0 0 1 0 1 
0 0 1 1 1 0 1 1 
1 1 1 1 1 0 1 0 
1 0 1 1 0 1 1 0 
1 0 1 1 0 1 1 1 
1 1 1 1 1 1 1 1 

Complexity: 4
Time: 332 seconds or 5.54 minutes or 0.09 hours