10 9
5
5 6 7 8 17 16 25 26 35 34 33 32 23 14 13 4 3 12 21 20 19 10 1 0 9 18 27 36 45 54 63 64 55 46 47 38 29 30 39 40 49 48 57 66 67 68 59 60 51 42 43 52 61 62 71 80 79 78 87 86 85 76 75 74 83 82 81 
1 1 0 1 1 2 1 1 1 
1 1 0 1 1 1 0 1 1 
1 1 1 1 0 1 0 1 1 
1 0 1 1 0 1 1 1 1 
1 0 1 1 1 0 1 1 0 
1 1 1 1 1 0 1 1 0 
1 1 0 1 0 1 1 1 1 
1 1 0 1 1 1 0 0 1 
0 0 1 1 1 0 1 1 1 
1 1 1 0 1 1 1 0 0 

Complexity: 4
Time: 157 seconds or 2.62 minutes or 0.04 hours