10 9
14
14 23 32 31 30 39 38 37 36 27 18 9 0 1 10 19 20 11 12 13 4 5 6 7 8 17 16 25 34 33 42 43 44 53 52 61 62 71 80 89 88 87 86 77 78 69 68 67 58 59 50 49 48 47 56 55 54 63 64 65 74 75 84 83 82 81 
1 1 0 0 1 1 1 1 1 
1 1 1 1 1 2 0 1 1 
1 1 1 0 0 1 0 1 0 
1 0 0 1 1 1 1 1 0 
1 1 1 1 0 0 1 1 1 
0 0 1 1 1 1 0 1 1 
1 1 1 0 1 1 0 1 1 
1 1 1 0 1 1 1 0 1 
0 0 1 1 0 1 1 0 1 
1 1 1 1 0 1 1 1 1 

Complexity: 4
Time: 492 seconds or 8.2 minutes or 0.14 hours