10 8
52
52 51 43 44 36 37 29 28 20 19 11 3 2 1 9 8 16 17 25 26 34 33 41 40 48 49 50 58 66 65 64 72 73 74 75 76 68 60 61 69 70 78 79 71 63 55 54 46 47 39 31 23 22 14 13 5 6 7 
0 1 1 1 0 1 1 1 
1 1 0 1 0 1 1 0 
1 1 0 1 1 0 1 1 
0 1 1 0 1 1 0 1 
0 1 1 0 1 1 0 1 
1 1 0 1 1 0 1 1 
1 1 1 1 2 0 1 1 
0 0 1 0 1 1 0 1 
1 1 1 0 1 1 1 1 
1 1 1 1 1 0 1 1 

Complexity: 4
Time: 429 seconds or 7.14 minutes or 0.12 hours