10 9
81
81 72 73 64 63 54 45 36 37 28 29 38 47 56 57 48 39 40 41 32 33 42 51 50 59 68 67 76 75 74 83 84 85 86 87 78 79 80 71 70 61 62 53 44 35 34 25 26 17 8 7 16 15 14 5 4 13 22 21 12 3 2 1 10 19 18 
0 1 1 1 1 1 0 1 1 
0 1 0 1 1 1 1 1 1 
1 1 0 1 1 0 0 1 1 
0 1 1 0 0 1 1 1 1 
1 1 1 1 1 1 1 0 1 
1 0 1 1 0 1 1 0 1 
1 0 1 1 0 1 0 1 1 
1 1 0 0 1 1 0 1 1 
1 1 1 1 1 0 1 1 1 
2 0 1 1 1 1 1 0 0 

Complexity: 4
Time: 3302 seconds or 55.04 minutes or 0.92 hours