10 8
7
7 6 5 4 12 13 21 22 14 15 23 31 39 47 46 45 37 29 28 27 19 18 26 34 33 41 49 50 58 59 51 43 44 52 53 54 62 63 71 70 78 77 69 68 76 75 74 73 65 64 56 48 40 32 24 16 8 9 10 2 
0 0 1 0 1 1 1 2 
1 1 1 0 1 1 1 1 
1 0 1 1 0 1 1 1 
1 0 1 1 1 1 0 1 
1 1 1 0 0 1 0 1 
1 1 0 1 1 1 1 1 
1 1 1 1 1 1 1 0 
1 0 1 1 0 0 1 1 
1 1 0 0 1 1 1 1 
0 1 1 1 1 1 1 0 

Complexity: 4
Time: 1001 seconds or 16.68 minutes or 0.28 hours