10 8
31
31 39 38 37 36 28 27 35 34 42 43 51 59 60 61 53 45 46 47 55 63 71 70 78 77 76 75 67 66 74 73 72 64 56 57 49 41 40 32 24 25 17 18 10 9 8 0 1 2 3 11 12 20 21 22 23 15 7 6 5 
1 1 1 1 0 1 1 1 
1 1 1 1 1 0 0 1 
0 1 1 0 1 1 1 1 
1 1 0 1 1 0 0 2 
1 0 1 1 1 1 1 1 
1 1 1 1 0 1 1 1 
0 1 0 1 0 1 0 1 
1 1 0 1 1 1 0 1 
1 0 1 1 0 0 1 1 
1 1 1 1 1 1 1 0 

Complexity: 4
Time:  4 seconds or 0.07 minutes or 0 hours