9 9
27
27 36 45 54 63 64 73 74 75 76 77 68 67 66 65 56 55 46 37 38 29 20 19 18 9 0 1 2 11 12 13 14 5 6 15 24 23 22 31 40 39 48 49 50 59 60 61 70 79 80 71 62 53 44 43 42 33 34 25 26 17 8 
1 1 1 0 0 1 1 0 1 
1 0 1 1 1 1 1 0 1 
1 1 1 0 1 1 1 1 1 
2 0 1 0 1 0 1 1 0 
1 1 1 1 1 0 1 1 1 
1 1 0 1 1 1 0 0 1 
1 1 1 0 0 1 1 1 1 
1 1 1 1 1 1 0 1 1 
0 1 1 1 1 1 0 1 1 

Complexity: 4
Time: 560 seconds or 9.33 minutes or 0.16 hours