9 9
71
71 62 61 52 53 44 35 26 25 16 15 24 33 42 51 50 41 40 31 22 21 30 29 28 37 46 47 48 57 58 67 68 69 70 79 78 77 76 75 66 65 64 73 72 63 54 45 36 27 18 9 10 11 2 3 4 13 14 5 6 7 8 
0 0 1 1 1 1 1 1 1 
1 1 1 0 1 1 1 1 0 
1 0 0 1 1 0 1 1 1 
1 1 1 1 1 0 1 0 1 
1 1 0 0 1 1 1 0 1 
1 1 1 1 0 1 1 1 1 
1 0 0 1 1 0 0 1 1 
1 1 1 1 1 1 1 1 2 
1 1 0 1 1 1 1 1 0 

Complexity: 4
Time: 370 seconds or 6.16 minutes or 0.1 hours