10 9
76
76 75 74 65 56 57 48 49 58 59 68 77 78 79 88 87 86 85 84 83 82 81 72 63 54 55 46 37 38 29 28 27 18 19 10 1 2 11 20 21 30 31 40 41 42 51 52 61 70 71 62 53 44 35 34 25 24 23 14 13 4 5 6 15 16 17 8 
0 1 1 0 1 1 1 0 1 
0 1 1 0 1 1 1 1 1 
1 1 1 1 0 1 1 1 0 
1 1 1 1 1 0 0 1 1 
0 1 1 0 1 1 1 0 1 
0 1 0 1 1 0 1 1 1 
1 1 1 1 1 1 0 1 1 
1 0 1 0 0 1 0 1 1 
1 0 1 1 2 1 1 1 0 
1 1 1 1 1 1 1 1 0 

Complexity: 4
Time: 2135 seconds or 35.59 minutes or 0.59 hours