11 8
62
62 61 69 68 67 66 74 73 72 80 81 82 83 84 85 77 78 79 71 63 55 54 46 47 39 38 37 29 30 22 14 15 7 6 5 4 12 20 19 18 26 34 35 36 44 52 51 50 58 57 56 48 40 41 33 32 24 16 8 9 10 2 
0 0 1 0 1 1 1 1 
1 1 1 0 1 0 1 1 
1 0 1 1 1 0 1 0 
1 0 1 0 0 1 1 0 
1 1 1 1 1 1 1 1 
1 1 0 0 1 0 1 1 
1 0 1 1 1 0 1 1 
1 1 1 0 0 1 2 1 
0 0 1 1 1 1 0 1 
1 1 1 0 0 1 1 1 
1 1 1 1 1 1 0 0 

Complexity: 4
Time: 1515 seconds or 25.25 minutes or 0.42 hours