10 8
75
75 76 77 69 68 60 52 53 54 62 70 71 63 55 47 46 38 37 36 28 20 19 18 17 25 33 34 35 43 51 50 49 57 58 66 74 73 72 64 56 48 40 32 24 16 8 9 1 2 10 11 12 13 5 6 7 15 14 22 30 31 
0 1 1 0 0 1 1 1 
1 1 1 1 1 1 1 1 
1 1 1 1 1 0 1 0 
1 1 0 0 1 0 1 1 
1 1 1 1 1 1 1 0 
1 0 0 1 0 0 1 1 
1 1 1 1 1 1 1 1 
1 1 1 0 1 0 1 1 
1 0 1 0 1 1 1 1 
1 1 1 2 1 1 0 0 

Complexity: 4
Time: 69 seconds or 1.15 minutes or 0.02 hours