10 8
52
52 44 43 35 36 37 29 30 22 14 15 7 6 5 4 12 20 19 11 3 2 10 9 8 16 17 25 26 34 33 32 40 48 56 57 49 50 58 66 67 68 60 61 62 54 46 38 39 47 55 63 71 79 78 77 76 75 74 73 72 
0 0 1 1 1 1 1 1 
1 1 1 1 1 0 1 1 
1 1 0 1 1 0 1 0 
0 1 1 0 0 1 1 0 
1 1 1 1 1 1 1 1 
1 0 0 1 1 0 1 1 
1 1 1 0 2 0 1 1 
1 1 1 0 1 1 1 1 
0 0 1 1 1 0 0 1 
1 1 1 1 1 1 1 1 

Complexity: 4
Time: 496 seconds or 8.27 minutes or 0.14 hours