11 8
35
35 43 44 45 53 54 55 63 71 70 78 86 85 77 69 68 60 59 67 75 83 82 74 73 81 80 72 64 56 57 58 50 49 41 33 32 24 16 17 9 1 2 10 18 26 27 19 20 12 4 5 6 14 15 23 22 30 29 37 38 39 
0 1 1 0 1 1 1 0 
0 1 1 0 1 0 1 1 
1 1 1 1 1 0 1 1 
1 0 1 1 0 1 1 0 
1 1 0 2 0 1 1 1 
0 1 0 1 1 1 0 0 
0 1 1 0 0 1 1 1 
1 1 1 1 1 0 0 1 
1 0 0 1 1 1 1 1 
1 1 1 1 0 1 1 0 
1 1 1 1 0 1 1 0 

Complexity: 4
Time: 11319 seconds or 188.65 minutes or 3.14 hours