10 9
75
75 74 65 66 57 48 39 40 41 32 23 24 15 6 7 16 17 26 25 34 43 44 53 62 61 52 51 60 59 58 67 68 69 78 79 80 89 88 87 86 85 84 83 82 73 72 63 54 55 46 37 38 29 28 27 18 9 10 1 2 11 20 21 22 13 4 
0 1 1 0 1 0 1 1 0 
1 1 1 0 1 0 1 1 1 
1 0 1 1 1 1 1 1 1 
1 1 1 0 0 1 0 1 0 
0 1 1 1 1 1 0 1 1 
0 1 0 1 0 0 1 1 1 
1 1 0 1 1 1 1 1 1 
1 0 1 1 1 1 1 0 0 
1 1 1 2 0 0 1 1 1 
0 1 1 1 1 1 1 1 1 

Complexity: 4
Time: 330 seconds or 5.5 minutes or 0.09 hours