11 8
75
75 83 84 85 86 78 70 71 63 55 47 46 45 53 61 69 68 60 59 51 50 42 43 35 36 37 29 30 31 23 22 14 6 5 13 12 20 19 11 10 2 1 9 17 16 24 25 26 34 33 32 40 48 56 57 65 66 74 73 81 80 
0 1 1 0 0 1 1 0 
0 1 1 1 1 1 1 0 
1 1 0 1 1 0 1 1 
1 1 1 0 0 1 1 1 
1 1 1 1 1 1 0 0 
1 0 1 1 0 1 1 1 
1 0 1 1 0 1 0 1 
1 1 0 1 1 1 0 1 
0 1 1 0 1 1 1 1 
0 1 1 2 0 0 1 0 
1 1 0 1 1 1 1 0 

Complexity: 4
Time: 2704 seconds or 45.07 minutes or 0.75 hours