9 9
51
51 52 61 70 71 80 79 78 77 68 59 58 67 76 75 74 73 72 63 64 55 46 47 56 57 48 49 40 41 42 33 34 43 44 35 26 17 8 7 16 15 14 23 22 21 30 29 28 37 36 27 18 9 0 1 10 11 12 13 4 
1 1 0 0 1 0 0 1 1 
1 1 1 1 1 1 1 1 1 
1 0 0 1 1 1 0 0 1 
1 1 1 1 0 0 1 1 1 
1 1 0 0 1 1 1 1 1 
0 1 1 1 1 0 2 1 0 
0 1 1 1 1 1 0 1 0 
1 1 0 0 1 1 0 1 1 
1 1 1 1 1 1 1 1 1 

Complexity: 4
Time: 282 seconds or 4.7 minutes or 0.08 hours