10 8
8
8 0 1 2 10 9 17 16 24 32 40 41 49 48 56 64 72 73 65 66 58 50 51 59 60 61 69 68 67 75 76 77 78 79 71 63 62 54 46 47 39 31 30 38 37 45 44 36 35 34 26 27 19 20 21 13 12 4 5 6 14 15 
1 1 1 0 1 1 1 0 
2 1 1 0 1 1 1 1 
1 1 0 1 1 1 0 0 
1 0 1 1 0 0 1 1 
1 0 1 1 1 1 1 1 
1 1 0 0 1 1 1 1 
1 1 1 1 0 0 1 0 
1 0 1 1 1 1 1 1 
1 1 1 1 1 1 0 1 
1 1 0 1 1 1 1 1 

Complexity: 4
Time: 2340 seconds or 38.99 minutes or 0.65 hours