11 8
65
65 57 56 64 72 73 81 82 74 75 67 59 60 68 76 77 85 86 87 79 71 70 62 54 53 45 46 47 39 38 30 29 21 22 23 15 14 6 5 4 12 20 19 18 10 2 1 0 8 16 24 25 26 34 35 36 44 43 42 50 49 41 40 
1 1 1 0 1 1 1 0 
1 0 1 0 1 0 1 1 
1 0 1 1 1 1 1 1 
1 1 1 0 0 1 1 0 
0 0 1 1 1 0 1 1 
1 1 1 1 1 1 1 1 
0 1 1 0 0 1 1 0 
1 1 0 1 1 0 1 0 
1 2 0 1 1 0 1 1 
1 1 1 1 1 1 0 1 
0 1 1 0 0 1 1 1 

Complexity: 4
Time: 2846 seconds or 47.43 minutes or 0.79 hours