9 9
52
52 53 62 71 80 79 78 77 76 67 68 69 60 59 50 41 42 33 24 25 34 35 26 17 8 7 16 15 14 13 4 3 2 11 20 21 22 31 40 39 38 47 48 57 66 65 74 73 72 63 64 55 46 37 36 27 28 19 18 9 0 
1 0 1 1 1 0 0 1 1 
1 0 1 0 1 1 1 1 1 
1 1 1 1 1 0 1 1 1 
1 1 0 0 1 0 1 1 1 
1 1 1 1 1 1 1 0 0 
0 1 1 1 0 1 0 2 1 
0 1 0 1 0 1 1 0 1 
1 1 1 1 1 1 1 0 1 
1 1 1 0 1 1 1 1 1 

Complexity: 4
Time: 750 seconds or 12.5 minutes or 0.21 hours