10 9
78
78 77 76 67 58 57 48 49 50 41 32 23 24 15 14 5 6 7 8 17 26 35 34 43 44 53 52 51 60 69 70 71 80 89 88 87 86 85 84 83 82 73 74 65 64 63 54 55 46 47 38 39 30 21 22 13 12 11 2 1 0 9 10 19 28 27 36 
1 1 1 0 0 1 1 1 1 
1 1 1 1 1 1 1 0 1 
0 1 0 1 1 1 1 0 1 
1 1 0 1 0 1 0 1 1 
1 0 1 1 0 1 0 1 1 
0 1 1 1 1 1 1 1 1 
1 1 0 1 1 0 1 0 0 
1 1 1 0 1 0 1 1 1 
0 1 1 0 1 1 2 0 1 
0 1 1 1 1 1 1 1 1 

Complexity: 4
Time: 1357 seconds or 22.62 minutes or 0.38 hours