11 8
39
39 31 30 29 21 20 28 36 35 34 42 50 51 52 60 61 53 45 46 47 55 54 62 70 71 79 87 86 85 77 76 75 67 66 74 82 81 80 72 64 65 57 49 48 40 41 33 25 26 18 17 16 8 0 1 9 10 11 12 4 5 13 14 15 
1 1 0 0 1 1 0 0 
1 1 1 1 1 1 1 1 
1 1 1 0 1 1 0 0 
0 1 1 0 1 1 1 1 
0 1 1 1 1 0 0 2 
1 1 1 0 0 1 1 1 
1 1 1 1 1 1 1 1 
0 1 0 0 1 1 1 0 
1 1 1 1 0 0 1 1 
1 0 1 1 1 1 0 1 
1 1 1 0 0 1 1 1 

Complexity: 4
Time: 1176 seconds or 19.61 minutes or 0.33 hours