9 9
28
28 37 46 45 36 27 18 9 10 1 2 3 12 11 20 29 30 31 22 23 24 15 14 5 6 7 16 17 26 35 34 43 44 53 62 71 80 79 70 69 60 51 42 41 40 49 48 47 56 57 58 67 68 77 76 75 74 73 64 63 
0 1 1 1 0 1 1 1 0 
1 1 1 1 0 1 1 1 1 
1 0 1 0 1 1 1 0 1 
1 2 1 1 1 0 0 1 1 
1 1 0 0 1 1 1 1 1 
1 1 1 1 1 0 1 0 1 
0 0 1 1 1 0 1 0 1 
1 1 0 0 1 1 1 1 1 
0 1 1 1 1 1 0 1 1 

Complexity: 4
Time: 579 seconds or 9.64 minutes or 0.16 hours