11 8
11
11 19 20 21 29 37 36 44 43 35 27 26 25 17 9 8 0 1 2 3 4 5 6 14 15 23 31 39 38 46 54 53 61 62 63 71 79 87 86 78 77 85 84 83 75 76 68 60 59 51 50 49 41 33 32 40 48 56 64 65 66 74 73 81 80 
1 1 1 1 1 1 1 0 
1 1 0 2 0 0 1 1 
0 1 0 1 1 1 0 1 
0 1 1 1 0 1 0 1 
1 1 0 1 1 1 1 1 
1 1 0 1 1 0 1 0 
1 1 1 1 0 1 1 0 
1 0 0 1 1 1 1 1 
1 1 1 0 1 0 0 1 
0 1 1 1 1 1 1 1 
1 1 0 1 1 1 1 1 

Complexity: 4
Time:  9 seconds or 0.15 minutes or 0 hours