11 8
20
20 28 27 26 34 42 50 51 59 67 68 69 61 62 63 55 54 53 45 44 36 37 38 39 31 23 15 14 22 21 13 5 4 3 11 10 9 1 0 8 16 17 25 24 32 40 48 49 57 65 64 72 80 81 73 74 75 76 84 85 86 78 79 
1 1 0 1 1 1 0 0 
1 1 1 1 0 1 1 1 
1 1 0 0 2 1 1 1 
1 1 1 1 1 0 0 1 
1 0 1 0 1 1 1 1 
1 0 1 0 1 1 0 0 
1 1 1 1 0 1 1 1 
0 1 0 1 0 1 1 1 
1 1 0 1 1 1 0 0 
1 1 1 1 1 0 1 1 
1 1 0 0 1 1 1 0 

Complexity: 4
Time: 1206 seconds or 20.1 minutes or 0.33 hours