9 9
22
22 23 32 33 24 15 14 5 4 13 12 11 2 1 10 9 18 27 36 37 28 29 20 21 30 39 40 49 48 47 46 55 64 63 72 73 74 75 66 57 58 59 68 67 76 77 78 79 80 71 62 61 60 51 42 43 44 35 26 17 16 7 
0 1 1 0 1 1 0 1 0 
1 1 1 1 1 1 1 1 1 
1 0 1 1 2 1 1 0 1 
1 1 1 1 0 1 1 0 1 
1 1 0 1 1 0 1 1 1 
0 1 1 1 1 0 1 0 0 
0 1 0 1 1 1 1 1 1 
1 1 0 1 1 1 0 0 1 
1 1 1 1 1 1 1 1 1 

Complexity: 4
Time: 45432 seconds or 757.2 minutes or 12.62 hours