9 9
12
12 3 4 13 14 23 24 15 6 7 16 17 26 35 34 43 44 53 62 71 70 79 78 77 76 67 58 59 60 51 42 41 40 31 30 29 20 19 10 1 0 9 18 27 28 37 36 45 54 63 64 73 74 75 66 65 56 47 48 
1 1 0 1 1 0 1 1 0 
1 1 0 2 1 1 1 1 1 
1 1 1 0 0 1 1 0 1 
1 1 1 1 1 0 0 1 1 
1 1 0 0 1 1 1 1 1 
1 0 1 1 0 0 1 0 1 
1 0 1 0 1 1 1 0 1 
1 1 1 1 1 0 0 1 1 
0 1 1 1 1 1 1 1 0 

Complexity: 4
Time: 626 seconds or 10.43 minutes or 0.17 hours