10 8
14
14 15 7 6 5 4 12 20 21 22 30 31 39 47 55 54 46 38 37 36 44 52 60 61 69 70 71 79 78 77 76 68 67 66 74 73 72 64 65 57 58 50 42 43 35 27 19 18 10 2 1 0 8 16 24 25 33 41 40 48 
1 1 1 0 1 1 1 1 
1 0 1 0 1 0 2 1 
1 0 1 1 1 1 1 0 
1 1 0 1 0 0 1 1 
0 1 0 1 1 1 1 1 
1 1 1 1 1 0 1 1 
1 0 1 0 1 0 1 1 
0 1 1 0 1 1 0 0 
1 1 1 1 1 1 1 1 
1 1 1 0 1 1 1 1 

Complexity: 4
Time: 84 seconds or 1.39 minutes or 0.02 hours