11 8
41
41 40 48 49 57 58 66 65 64 72 73 81 82 74 75 76 84 85 86 87 79 71 63 55 54 62 70 69 61 60 59 51 43 44 45 37 29 28 27 19 18 26 34 33 25 24 16 8 9 10 2 3 4 12 13 5 6 7 15 23 22 30 38 39 
0 0 1 1 1 1 1 1 
1 1 1 0 1 1 0 1 
1 0 1 1 0 0 1 1 
1 1 1 1 1 1 1 0 
0 1 1 0 0 1 1 1 
1 2 0 1 1 1 0 0 
1 1 0 1 0 0 1 1 
0 1 1 1 1 1 1 1 
1 1 1 0 0 1 1 1 
1 1 1 1 1 0 0 1 
0 1 1 0 1 1 1 1 

Complexity: 4
Time: 1576 seconds or 26.26 minutes or 0.44 hours