11 8
5
5 6 14 22 23 31 30 29 28 20 12 4 3 2 10 18 17 25 26 27 35 36 44 43 42 41 49 50 51 59 67 68 69 61 53 54 46 38 39 47 55 63 71 79 87 86 78 77 76 75 83 82 74 66 65 73 72 64 56 48 40 32 24 16 8 0 
1 0 1 1 1 2 1 0 
1 0 1 0 1 0 1 0 
1 1 1 0 1 0 1 1 
1 1 1 1 1 1 1 1 
1 0 0 1 1 0 1 1 
1 1 1 1 1 0 1 1 
1 1 1 1 0 1 1 1 
1 0 0 1 0 1 0 1 
1 1 1 1 1 1 0 1 
1 1 1 1 1 1 1 1 
0 0 1 1 0 0 1 1 

Complexity: 4
Time: 660 seconds or 11.01 minutes or 0.18 hours