10 9
52
52 61 62 71 80 89 88 79 70 69 68 67 76 77 86 85 84 83 82 81 72 73 74 65 64 55 46 45 36 27 18 19 28 37 38 47 56 57 58 59 50 49 40 31 30 21 22 23 24 33 42 43 44 35 26 17 16 7 6 5 4 13 12 11 2 1 0 
1 1 1 0 1 1 1 1 0 
0 0 1 1 1 0 0 1 1 
1 1 0 1 1 1 1 0 1 
1 1 0 1 1 0 1 0 1 
1 1 1 0 1 0 1 1 1 
1 1 1 0 1 1 0 2 0 
0 1 1 1 1 1 0 1 1 
0 1 1 0 1 1 1 1 1 
1 1 1 0 1 1 0 1 1 
1 1 1 1 1 1 0 1 1 

Complexity: 4
Time: 204 seconds or 3.41 minutes or 0.06 hours