9 9
28
28 37 36 45 46 47 56 65 64 63 72 73 74 75 66 67 58 49 50 41 32 31 40 39 30 21 20 19 18 9 10 11 2 3 4 13 14 5 6 7 16 17 26 25 24 33 34 43 52 53 62 71 80 79 70 69 60 59 68 77 
0 0 1 1 1 1 1 1 0 
1 1 1 0 1 1 0 1 1 
1 1 1 1 0 0 1 1 1 
0 2 0 1 1 1 1 1 0 
1 1 0 1 1 1 0 1 0 
1 1 1 0 1 1 0 1 1 
0 0 1 0 1 1 1 0 1 
1 1 1 1 1 1 1 1 1 
1 1 1 1 0 1 0 1 1 

Complexity: 4
Time: 251 seconds or 4.19 minutes or 0.07 hours