11 8
52
52 44 45 37 29 28 36 35 27 19 18 10 2 3 4 12 13 5 6 7 15 14 22 30 31 39 47 55 54 53 61 62 70 78 79 87 86 85 84 76 68 67 59 58 66 74 82 81 80 72 64 65 57 49 50 42 41 40 32 33 25 17 16 8 0 
1 0 1 1 1 1 1 1 
1 0 1 0 1 1 1 1 
1 1 1 1 0 0 1 0 
0 1 0 1 1 1 1 1 
1 1 0 1 1 1 0 1 
1 1 1 0 1 1 0 1 
0 1 1 0 2 1 1 1 
0 1 1 1 0 1 1 0 
1 1 1 1 1 0 1 0 
1 0 1 0 1 0 1 1 
1 1 1 0 1 1 1 1 

Complexity: 4
Time: 110 seconds or 1.83 minutes or 0.03 hours