9 9
64
64 73 74 75 76 67 68 77 78 79 70 71 62 61 60 51 52 43 44 35 26 25 16 7 6 5 4 13 14 23 24 33 32 41 40 39 48 49 58 57 56 55 54 45 46 37 36 27 18 19 28 29 30 21 12 11 2 1 0 
1 1 1 0 1 1 1 1 0 
0 0 1 1 1 1 0 1 0 
1 1 0 1 0 1 1 1 1 
1 1 1 1 0 1 1 0 1 
1 1 0 1 1 1 0 1 1 
1 1 0 1 1 0 1 1 0 
1 1 1 1 1 0 1 1 1 
0 2 0 0 1 1 0 1 1 
0 1 1 1 1 1 1 1 0 

Complexity: 4
Time: 280 seconds or 4.67 minutes or 0.08 hours