11 8
26
26 34 42 43 44 36 28 29 30 22 14 15 7 6 5 4 12 20 19 11 10 2 1 0 8 9 17 25 24 32 40 48 56 57 49 50 58 66 67 68 60 52 53 54 46 38 39 47 55 63 71 79 78 70 69 77 85 84 83 82 74 73 72 
1 1 1 0 1 1 1 1 
1 1 1 1 1 0 1 1 
0 1 0 1 1 0 1 0 
1 1 2 0 1 1 1 0 
1 0 1 0 1 0 1 1 
1 0 1 1 1 0 1 1 
1 1 1 0 1 1 1 1 
1 1 1 0 1 0 0 1 
0 0 1 1 1 1 1 1 
1 1 1 0 0 1 1 1 
0 0 1 1 1 1 0 0 

Complexity: 4
Time: 2345 seconds or 39.08 minutes or 0.65 hours