11 8
12
12 20 28 27 26 34 35 43 42 41 49 48 40 32 24 16 8 9 17 18 10 2 3 4 5 13 14 15 23 22 30 38 37 45 53 52 51 59 58 66 65 64 72 80 81 82 83 75 76 68 69 77 85 86 78 79 71 63 62 54 55 47 
0 0 1 1 1 1 0 0 
1 1 1 0 2 1 1 1 
1 1 1 0 1 0 1 1 
1 0 1 1 1 0 1 0 
1 0 1 1 0 1 1 0 
1 1 1 1 0 1 0 1 
1 1 0 1 1 1 1 1 
0 0 1 1 0 0 1 1 
1 1 1 0 1 1 0 1 
1 0 0 1 1 1 1 1 
1 1 1 1 0 1 1 0 

Complexity: 4
Time: 1792 seconds or 29.87 minutes or 0.5 hours