9 9
0
0 1 2 3 12 21 22 23 14 5 6 7 16 17 26 25 24 33 32 31 40 39 48 47 38 29 28 19 10 9 18 27 36 45 54 63 64 55 56 65 74 75 66 57 58 59 50 51 52 43 44 53 62 71 80 79 70 69 68 77 
2 1 1 1 0 1 1 1 0 
1 1 0 1 0 1 0 1 1 
1 1 0 1 1 1 1 1 1 
1 1 1 0 1 1 1 0 0 
1 0 1 1 1 0 0 1 1 
1 0 1 1 0 1 1 1 1 
1 1 1 1 1 1 0 0 1 
1 1 1 1 0 1 1 1 1 
0 0 1 1 0 1 0 1 1 

Complexity: 4
Time:  4 seconds or 0.07 minutes or 0 hours