11 8
31
31 23 22 14 6 5 4 3 11 10 2 1 9 17 16 24 32 40 41 33 34 26 27 28 20 21 29 37 38 46 54 55 63 71 79 87 86 78 70 69 61 60 52 44 43 51 50 49 57 65 64 72 80 81 82 74 66 67 75 76 84 
0 1 1 1 1 1 1 0 
0 1 1 1 0 0 1 0 
1 1 0 0 1 1 1 1 
1 0 1 1 1 1 0 2 
1 1 1 0 0 1 1 0 
1 1 0 1 1 0 1 0 
0 1 1 1 1 0 1 1 
0 1 0 0 1 1 0 1 
1 1 1 1 0 1 1 1 
1 0 1 1 1 0 1 1 
1 1 1 0 1 0 1 1 

Complexity: 4
Time: 191 seconds or 3.19 minutes or 0.05 hours