10 9
12
12 13 22 31 32 41 40 39 38 47 48 57 66 67 58 59 60 51 52 43 34 25 24 15 14 5 6 7 16 17 26 35 44 53 62 71 70 79 88 87 78 77 86 85 84 75 74 73 82 81 72 63 64 55 54 45 36 27 18 19 28 29 20 11 2 1 0 
1 1 1 0 0 1 1 1 0 
0 0 1 2 1 1 1 1 1 
1 1 1 0 1 0 1 1 1 
1 1 1 0 1 1 0 1 1 
1 0 1 1 1 1 0 1 1 
1 0 1 1 0 0 1 1 1 
1 1 0 1 1 1 1 0 1 
1 1 0 1 1 0 0 1 1 
1 1 1 1 0 1 1 1 0 
1 1 0 1 1 1 1 1 0 

Complexity: 4
Time: 1699 seconds or 28.32 minutes or 0.47 hours