10 9
16
16 7 8 17 26 35 44 43 52 51 50 59 60 61 70 71 80 79 88 87 78 77 76 67 66 75 84 83 82 81 72 73 64 55 56 47 48 49 40 31 32 33 24 23 14 5 4 13 22 21 12 11 2 1 0 9 18 19 28 29 38 37 46 45 
1 1 1 0 1 1 0 1 1 
1 0 1 1 1 1 0 2 1 
1 1 0 1 1 1 1 0 1 
0 1 1 0 1 1 1 0 1 
0 1 1 0 1 0 0 1 1 
1 1 1 1 1 1 1 1 0 
0 1 1 0 0 1 1 1 0 
0 1 0 1 1 0 0 1 1 
1 1 0 1 1 1 1 1 1 
1 1 1 1 0 0 1 1 0 

Complexity: 4
Time: 611 seconds or 10.18 minutes or 0.17 hours