11 8
41
41 40 32 24 25 17 16 8 9 1 2 10 18 19 20 28 36 35 34 42 43 44 45 53 61 60 59 67 66 58 50 49 48 56 64 72 73 74 82 83 84 76 77 78 86 87 79 71 70 62 54 46 47 39 38 30 31 23 22 21 13 12 4 5 6 7 
0 1 1 0 1 1 1 1 
1 1 1 0 1 1 0 0 
1 1 1 1 1 1 1 1 
1 1 0 0 1 0 1 1 
1 0 1 1 1 0 1 1 
1 2 1 1 1 1 1 1 
1 1 1 0 0 1 1 0 
1 0 1 1 1 1 1 0 
1 0 1 1 0 0 1 1 
1 1 1 0 1 1 1 1 
0 0 1 1 1 0 1 1 

Complexity: 4
Time: 77 seconds or 1.28 minutes or 0.02 hours