11 8
20
20 19 27 35 34 42 41 40 48 49 57 65 64 72 80 81 82 74 66 67 59 51 52 44 45 53 61 69 77 76 84 85 86 78 70 71 63 55 47 46 38 37 29 30 22 23 15 14 13 5 4 3 2 10 18 17 25 24 16 8 0 
1 0 1 1 1 1 0 0 
1 0 1 0 0 1 1 1 
1 1 1 1 2 0 1 1 
1 1 0 1 0 1 1 0 
0 0 1 1 0 1 1 0 
1 1 1 0 1 1 1 1 
1 1 0 1 1 1 0 1 
0 1 0 1 0 1 0 1 
1 1 1 1 0 1 1 1 
1 0 1 0 1 1 1 0 
1 1 1 0 1 1 1 0 

Complexity: 4
Time: 1688 seconds or 28.13 minutes or 0.47 hours