10 9
6
6 7 16 25 26 35 44 43 42 33 32 23 14 13 12 3 2 1 0 9 10 11 20 21 30 39 40 49 50 51 60 61 62 71 80 89 88 87 78 69 68 67 76 85 84 75 74 83 82 73 64 63 54 55 56 57 48 47 46 37 28 27 
1 1 1 1 0 0 2 1 0 
1 1 1 1 1 1 0 1 0 
0 0 1 1 0 1 0 1 1 
1 1 0 1 0 1 1 0 1 
0 1 0 1 1 0 1 1 1 
0 1 1 1 1 1 1 0 0 
1 1 1 1 0 0 1 1 1 
1 1 0 0 1 1 1 0 1 
0 1 1 1 1 0 1 0 1 
0 1 1 1 1 0 1 1 1 

Complexity: 4
Time: 1058 seconds or 17.63 minutes or 0.29 hours