11 8
70
70 62 63 71 79 87 86 78 77 69 68 76 75 83 82 81 73 74 66 58 59 51 52 53 45 46 47 39 38 30 31 23 15 14 6 5 13 21 20 28 36 35 43 42 34 26 18 10 11 3 2 1 0 8 9 17 25 33 32 40 48 49 57 56 64 
1 1 1 1 0 1 1 0 
1 1 1 1 0 1 1 1 
0 1 1 0 1 1 0 1 
0 1 1 0 1 0 1 1 
1 1 1 1 1 0 1 1 
1 0 1 1 0 1 1 1 
1 1 0 1 1 1 0 0 
1 1 1 1 0 0 1 1 
1 0 1 0 1 1 2 1 
0 1 1 1 1 1 1 1 
0 1 1 1 0 0 1 1 

Complexity: 4
Time: 144 seconds or 2.4 minutes or 0.04 hours