9 9
23
23 24 33 34 25 16 17 8 7 6 5 14 13 4 3 2 1 10 9 18 19 20 21 30 31 40 41 50 59 60 61 52 43 44 53 62 71 70 79 78 77 76 67 66 57 48 47 38 37 28 27 36 45 54 55 64 65 74 73 72 
0 1 1 1 1 1 1 1 1 
1 1 0 0 1 1 0 1 1 
1 1 1 1 0 2 1 1 0 
1 1 0 1 1 0 1 1 0 
1 1 1 0 1 1 0 1 1 
1 0 1 1 0 1 0 1 1 
1 1 0 1 0 1 1 1 1 
0 1 1 1 1 0 0 1 1 
1 1 1 0 1 1 1 1 0 

Complexity: 4
Time: 42 seconds or 0.7 minutes or 0.01 hours