10 8
27
27 35 36 28 20 21 22 23 15 14 6 5 4 3 11 19 18 10 9 1 0 8 16 24 25 33 32 40 41 42 50 49 48 56 64 72 73 74 66 58 59 67 75 76 77 69 68 60 52 44 45 37 38 30 31 39 47 55 54 62 70 71 
1 1 0 1 1 1 1 0 
1 1 1 1 0 0 1 1 
1 0 1 1 1 1 1 1 
1 1 0 2 1 0 1 1 
1 1 0 1 1 1 1 1 
1 1 1 0 1 1 0 1 
1 1 1 0 1 0 1 1 
1 0 1 1 1 0 1 0 
1 0 1 1 1 1 1 1 
1 1 1 1 1 1 0 0 

Complexity: 4
Time: 30 seconds or 0.5 minutes or 0.01 hours