10 9
44
44 35 34 43 52 61 60 69 70 71 80 89 88 87 86 77 68 67 76 85 84 75 74 83 82 81 72 63 64 55 54 45 36 27 28 19 18 9 0 1 2 11 12 3 4 5 14 13 22 31 30 29 38 47 56 57 48 49 50 41 32 33 24 15 16 17 8 
1 1 1 1 1 1 0 0 1 
1 0 1 1 1 1 1 1 1 
1 1 0 0 1 0 1 0 0 
1 1 1 1 1 1 1 1 1 
1 0 1 0 0 1 0 1 2 
1 0 1 1 1 1 0 1 0 
1 1 1 1 0 0 1 1 0 
1 1 0 0 1 1 1 1 1 
1 0 1 1 1 1 0 0 1 
1 1 1 1 1 1 1 1 1 

Complexity: 4
Time: 9892 seconds or 164.87 minutes or 2.75 hours