11 8
40
40 48 56 57 65 64 72 80 81 82 74 75 67 59 51 50 42 34 33 32 24 16 8 0 1 9 17 18 19 27 28 29 37 36 44 45 53 61 69 68 76 77 85 86 87 79 71 63 62 54 46 38 39 31 23 22 14 15 7 6 5 13 12 11 3 
1 1 0 1 0 1 1 1 
1 1 0 1 1 1 1 1 
1 1 1 1 0 0 1 1 
1 0 0 1 1 1 0 1 
1 1 1 0 1 1 1 1 
2 0 1 0 1 1 1 0 
1 0 1 1 0 1 1 0 
1 1 0 1 0 1 1 1 
1 1 0 1 1 1 0 1 
1 0 1 1 1 1 0 1 
1 1 1 0 0 1 1 1 

Complexity: 4
Time: 801 seconds or 13.36 minutes or 0.22 hours