10 8
10
10 2 1 0 8 16 17 18 26 34 33 32 40 41 49 57 58 66 67 68 60 52 51 43 35 36 28 20 21 13 12 11 3 4 5 6 7 15 23 31 39 38 30 29 37 45 53 54 55 63 71 70 69 77 76 75 74 73 72 64 
1 1 1 1 1 1 1 1 
1 0 2 1 1 1 0 1 
1 1 1 0 1 1 0 1 
0 0 1 0 1 1 1 1 
1 1 1 1 1 1 1 1 
1 1 0 1 0 1 0 0 
0 1 0 1 1 1 1 1 
0 1 1 0 1 0 0 1 
1 0 1 1 1 1 1 1 
1 1 1 1 1 1 0 0 

Complexity: 4
Time: 67 seconds or 1.11 minutes or 0.02 hours