11 8
32
32 33 25 17 16 8 0 1 2 10 18 19 27 35 36 37 45 53 61 60 59 51 43 42 41 40 48 49 57 56 64 72 80 81 82 74 66 67 68 76 84 85 86 78 79 71 70 62 63 55 47 39 38 30 31 23 15 14 22 21 20 12 4 5 
1 1 1 0 1 1 0 0 
1 0 1 0 1 0 1 1 
1 1 1 1 1 1 1 1 
0 1 0 1 0 0 1 1 
2 1 0 1 1 1 1 1 
1 1 1 1 0 1 0 1 
1 1 0 1 0 1 0 1 
1 1 0 1 1 1 1 1 
1 0 1 1 1 0 1 1 
1 0 1 0 1 0 1 1 
1 1 1 0 1 1 1 0 

Complexity: 4
Time: 651 seconds or 10.85 minutes or 0.18 hours