10 8
24
24 32 33 41 40 48 49 50 58 57 65 64 72 73 74 75 67 68 76 77 78 79 71 70 62 61 53 45 44 52 51 43 35 27 26 18 17 16 8 0 1 2 3 11 19 20 28 29 21 13 5 6 14 15 23 31 39 38 46 54 55 
1 1 1 1 0 1 1 0 
1 0 0 1 0 1 1 1 
1 1 1 1 1 1 0 1 
2 0 1 1 1 1 0 1 
1 1 0 1 0 0 1 1 
1 1 0 1 1 1 1 0 
1 1 1 1 1 1 1 1 
0 1 1 0 0 1 1 0 
1 1 0 1 1 0 1 1 
1 1 1 1 1 1 1 1 

Complexity: 4
Time: 240 seconds or 4 minutes or 0.07 hours