9 9
60
60 61 62 71 80 79 70 69 78 77 68 67 76 75 74 73 64 63 54 45 36 27 18 19 20 11 10 1 2 3 12 13 22 23 24 25 34 33 32 31 30 39 38 37 46 55 56 57 58 49 50 51 42 43 44 35 26 17 16 7 6 5 
0 1 1 1 0 1 1 1 0 
0 1 1 1 1 0 0 1 1 
1 1 1 0 1 1 1 1 1 
1 0 0 1 1 1 1 1 1 
1 1 1 1 0 0 1 1 1 
1 1 0 0 1 1 1 0 0 
1 1 1 1 1 0 2 1 1 
1 1 0 0 1 1 1 1 1 
0 1 1 1 1 1 1 1 1 

Complexity: 4
Time: 505 seconds or 8.42 minutes or 0.14 hours