9 9
7
7 6 5 4 13 22 21 30 31 32 23 24 15 16 17 26 25 34 43 44 53 62 71 80 79 70 69 60 51 50 41 40 39 38 37 46 47 56 57 58 67 68 77 76 75 74 73 64 63 54 45 36 27 28 19 10 11 2 1 0 
1 1 1 0 1 1 1 2 0 
0 1 1 0 1 0 1 1 1 
0 1 0 1 1 1 1 1 1 
1 1 0 1 1 1 0 1 0 
1 1 1 1 1 1 0 1 1 
1 1 1 0 0 1 1 0 1 
1 0 1 1 1 0 1 0 1 
1 1 0 0 1 1 1 1 1 
0 1 1 1 1 1 0 1 1 

Complexity: 4
Time: 677 seconds or 11.28 minutes or 0.19 hours