11 8
4
4 3 2 10 9 8 16 24 25 33 41 49 48 56 64 72 80 81 73 65 66 58 59 60 52 53 61 69 68 76 75 83 84 85 86 78 79 71 63 55 54 46 38 39 31 23 22 30 29 28 36 44 43 42 34 26 18 19 20 12 13 5 6 7 
0 0 1 1 2 1 1 1 
1 1 1 0 1 1 0 0 
1 0 1 1 1 0 1 1 
1 1 1 0 1 1 1 1 
0 1 1 0 1 0 1 1 
0 1 1 1 1 0 1 0 
1 1 0 0 1 1 1 1 
1 0 1 1 1 1 0 1 
1 1 1 0 1 1 0 1 
1 1 0 1 1 0 1 1 
1 1 0 1 1 1 1 0 

Complexity: 4
Time: 242 seconds or 4.04 minutes or 0.07 hours