10 8
65
65 66 58 59 67 75 76 77 78 79 71 70 69 61 60 52 44 43 42 34 35 27 19 20 21 29 37 38 46 54 55 47 39 31 23 15 14 6 5 4 12 11 10 9 1 0 8 16 17 25 33 32 40 41 49 48 56 64 72 
1 1 0 0 1 1 1 0 
1 1 1 1 1 0 1 1 
1 1 0 1 1 1 0 1 
0 1 0 1 0 1 0 1 
1 1 1 1 0 1 1 1 
1 1 1 1 1 0 1 1 
1 1 0 0 1 0 1 1 
1 0 1 1 1 1 0 0 
1 2 1 1 0 1 1 1 
1 0 0 1 1 1 1 1 

Complexity: 4
Time: 45 seconds or 0.75 minutes or 0.01 hours