10 9
42
42 41 32 23 14 15 16 7 8 17 26 25 34 43 52 53 62 71 70 61 60 59 58 49 48 39 30 21 22 13 4 3 12 11 10 1 0 9 18 19 28 27 36 37 38 47 46 55 64 63 72 73 82 83 74 65 66 67 76 85 86 77 78 79 88 
1 1 0 1 1 0 0 1 1 
1 1 1 1 1 1 1 1 1 
1 1 0 1 1 1 0 1 1 
1 1 0 1 0 1 0 1 0 
1 1 1 1 0 1 2 1 0 
0 1 1 1 1 0 0 1 1 
0 1 0 0 1 1 1 1 1 
1 1 1 1 1 0 0 1 1 
1 1 1 0 1 1 1 1 0 
0 1 1 0 1 1 0 1 0 

Complexity: 4
Time: 809 seconds or 13.48 minutes or 0.22 hours