9 9
76
76 77 68 69 78 79 70 61 62 53 44 35 26 17 8 7 6 5 14 13 4 3 12 11 2 1 0 9 10 19 20 29 30 39 40 31 32 23 24 25 34 33 42 51 50 49 58 67 66 75 74 73 64 63 54 55 56 47 46 37 28 27 
1 1 1 1 1 1 1 1 1 
1 1 1 1 1 1 0 0 1 
0 1 1 0 0 1 1 1 1 
1 1 1 1 1 1 1 1 1 
0 1 0 1 1 0 1 0 1 
0 1 1 0 1 1 1 0 1 
1 1 1 0 1 0 0 1 1 
1 1 0 1 1 1 1 1 0 
0 1 1 1 2 1 1 1 0 

Complexity: 4
Time: 2403 seconds or 40.05 minutes or 0.67 hours