10 9
15
15 16 17 8 7 6 5 4 13 12 11 10 1 0 9 18 19 28 27 36 45 46 47 38 39 30 21 22 23 24 33 34 35 44 53 62 71 70 61 52 51 50 41 40 49 58 59 68 67 66 65 56 55 64 73 72 81 82 83 84 85 76 77 78 79 88 89 
1 1 0 0 1 1 1 1 1 
1 1 1 1 1 0 2 1 1 
1 1 0 1 1 1 1 0 0 
1 1 0 1 0 0 1 1 1 
1 0 1 1 1 1 0 0 1 
1 1 1 0 1 1 1 1 1 
0 1 1 0 1 1 0 1 1 
0 1 1 1 1 1 0 1 1 
1 1 0 0 1 1 1 1 0 
1 1 1 1 1 0 0 1 1 

Complexity: 4
Time: 90 seconds or 1.51 minutes or 0.03 hours