10 9
20
20 19 18 9 10 1 2 11 12 13 22 31 32 33 24 15 14 5 6 7 8 17 26 35 34 43 52 53 62 71 80 79 88 87 86 85 84 83 82 81 72 73 74 65 64 55 56 57 58 67 76 77 78 69 60 51 50 49 40 39 38 29 28 37 46 45 
0 1 1 0 0 1 1 1 1 
1 1 1 1 1 1 1 0 1 
1 1 2 0 1 0 1 0 1 
0 1 1 0 1 1 1 1 1 
0 1 1 1 1 0 0 1 0 
1 1 0 0 1 1 1 1 1 
0 1 1 1 1 0 1 0 1 
0 1 1 0 1 0 1 0 1 
1 1 1 0 1 1 1 1 1 
1 1 1 1 1 1 1 1 0 

Complexity: 4
Time: 507 seconds or 8.45 minutes or 0.14 hours