11 8
51
51 59 58 66 65 64 72 73 74 82 83 75 76 68 69 77 78 86 87 79 71 63 62 54 53 52 44 45 46 38 39 31 23 22 30 29 28 20 19 27 35 34 42 41 49 48 40 32 24 25 17 16 8 0 1 9 10 11 3 4 5 13 14 6 7 
1 1 0 1 1 1 1 1 
1 1 1 1 0 1 1 0 
1 1 0 1 1 0 1 1 
1 1 0 1 1 1 1 1 
1 0 1 1 0 0 1 1 
1 1 1 0 1 1 1 0 
1 1 0 2 1 1 1 0 
0 0 1 1 0 0 1 1 
1 1 1 0 1 1 0 1 
1 1 1 1 1 1 1 1 
0 0 1 1 0 0 1 1 

Complexity: 4
Time: 18 seconds or 0.3 minutes or 0.01 hours