10 9
1
1 0 9 18 27 28 29 38 37 46 45 54 63 72 73 82 83 84 75 74 65 56 57 48 49 58 67 68 77 86 87 88 79 70 71 62 61 60 51 52 43 42 33 32 41 40 31 22 21 20 11 12 3 4 13 14 15 6 7 16 25 26 35 
1 2 0 1 1 0 1 1 0 
1 0 1 1 1 1 1 1 0 
1 0 1 1 1 0 0 1 1 
1 1 1 0 1 1 1 0 1 
0 1 1 0 1 1 1 1 0 
1 1 0 1 1 0 1 1 0 
1 0 1 1 1 0 1 1 1 
1 0 1 0 1 1 0 1 1 
1 1 1 1 0 1 0 1 0 
0 1 1 1 0 1 1 1 0 

Complexity: 4
Time: 1326 seconds or 22.1 minutes or 0.37 hours