10 8
12
12 4 5 6 7 15 23 22 30 31 39 38 46 47 55 54 62 63 71 79 78 70 69 61 60 68 76 75 67 66 65 73 72 64 56 57 49 50 51 43 44 45 37 29 21 20 19 11 10 2 1 9 8 16 17 25 26 27 35 34 33 32 40 
0 1 1 0 1 1 1 1 
1 1 1 1 2 0 0 1 
1 1 0 1 1 1 1 1 
0 1 1 1 0 1 1 1 
1 1 1 1 0 1 1 1 
1 0 0 1 1 1 1 1 
0 1 1 1 0 0 1 1 
1 1 0 0 1 1 1 1 
1 1 1 1 1 1 1 1 
1 1 0 1 1 0 1 1 

Complexity: 4
Time: 1712 seconds or 28.53 minutes or 0.48 hours