10 8
26
26 18 17 16 24 25 33 41 40 48 56 64 72 73 65 66 74 75 76 77 69 70 78 79 71 63 55 54 46 38 37 45 53 52 60 59 58 50 42 43 35 27 28 29 21 22 30 31 23 15 7 6 5 4 12 11 10 2 1 0 
1 1 1 0 1 1 1 1 
0 0 1 1 1 0 0 1 
1 1 1 0 0 1 1 1 
1 1 2 1 1 1 1 1 
0 1 0 1 0 1 1 0 
1 1 1 1 0 1 1 0 
1 0 1 0 1 1 1 1 
1 0 1 1 1 0 0 1 
1 1 1 0 0 1 1 1 
1 1 1 1 1 1 1 1 

Complexity: 4
Time: 35 seconds or 0.58 minutes or 0.01 hours