11 8
29
29 28 36 37 38 30 22 23 15 14 13 5 4 12 20 19 11 10 2 1 9 8 16 24 32 33 25 26 34 42 43 44 45 53 52 60 68 67 59 58 57 49 48 56 64 72 80 81 73 74 75 83 84 76 77 85 86 87 79 71 70 62 63 55 47 
0 1 1 0 1 1 0 0 
1 1 1 1 1 1 1 1 
1 0 0 1 1 0 1 1 
1 1 1 0 1 2 1 0 
1 1 1 0 1 1 1 0 
0 0 1 1 1 1 0 1 
1 1 0 0 1 1 0 1 
1 1 1 1 1 0 1 1 
1 0 0 1 1 0 1 1 
1 1 1 1 1 1 0 1 
1 1 0 1 1 1 1 1 

Complexity: 4
Time: 350 seconds or 5.84 minutes or 0.1 hours