11 8
74
74 66 65 57 56 64 72 80 81 82 83 84 76 68 69 70 78 86 87 79 71 63 55 47 46 45 53 61 60 59 51 50 42 43 35 36 37 29 30 31 23 15 14 13 5 4 12 20 19 11 3 2 1 0 8 16 17 18 26 25 33 41 40 
1 1 1 1 1 1 0 0 
1 0 0 1 1 1 1 1 
1 1 1 1 1 0 0 1 
0 1 1 0 0 1 1 1 
0 1 0 1 1 1 0 0 
1 1 1 1 0 1 1 1 
0 0 1 1 0 1 0 1 
1 1 0 1 1 1 0 1 
1 1 1 0 1 1 1 1 
1 0 2 0 1 0 1 1 
1 1 1 1 1 0 1 1 

Complexity: 4
Time: 39 seconds or 0.65 minutes or 0.01 hours