10 9
70
70 69 78 77 76 75 66 57 58 59 50 41 42 43 34 25 26 35 44 53 52 61 62 71 80 89 88 87 86 85 84 83 82 81 72 73 64 63 54 55 56 47 46 37 28 27 18 9 10 1 2 3 12 11 20 29 38 39 40 31 32 23 22 13 14 15 6 7 8 
0 1 1 1 0 0 1 1 1 
1 1 1 1 1 1 1 0 0 
1 0 1 0 1 1 0 1 1 
1 1 1 0 1 1 0 1 1 
0 1 1 1 1 1 1 1 1 
0 1 1 0 0 1 0 1 1 
1 1 1 1 1 1 0 1 1 
1 1 0 1 0 0 1 2 1 
1 1 0 1 1 1 1 0 1 
1 1 1 1 1 1 1 1 1 

Complexity: 4
Time: 6974 seconds or 116.23 minutes or 1.94 hours