10 8
42
42 34 33 32 24 16 8 0 1 9 17 18 19 27 28 36 44 45 53 61 60 52 51 50 49 48 56 57 65 73 74 66 67 75 76 77 78 79 71 70 62 54 46 47 39 38 30 31 23 15 7 6 5 13 21 20 12 11 3 
1 1 0 1 0 1 1 1 
1 1 0 1 1 1 0 1 
1 1 1 1 1 1 0 1 
1 0 0 1 1 0 1 1 
1 1 1 0 1 0 1 1 
0 0 2 0 1 1 1 1 
1 1 1 1 1 1 1 0 
1 1 0 0 1 1 1 0 
0 1 1 1 0 0 1 1 
0 1 1 1 1 1 1 1 

Complexity: 4
Time: 18 seconds or 0.3 minutes or 0.01 hours