11 9
15
15 6 7 8 17 16 25 34 35 44 53 62 61 70 79 80 89 88 97 96 87 86 95 94 93 92 83 82 81 72 63 64 65 74 75 76 77 68 59 60 51 42 33 32 23 14 5 4 13 12 21 30 29 38 39 40 49 58 57 56 55 46 37 36 27 18 19 10 1 2 
0 1 1 0 1 1 1 1 1 
0 1 0 1 1 1 2 1 1 
1 1 0 1 0 1 0 1 0 
1 0 1 1 0 1 1 1 1 
1 1 1 1 1 0 1 0 1 
0 1 0 0 1 0 1 0 1 
0 1 1 1 1 1 1 1 1 
1 1 1 0 0 1 0 1 0 
1 0 1 1 1 1 0 1 1 
1 1 1 0 0 1 1 1 1 
0 0 1 1 1 1 1 1 0 

Complexity: 5
Time: 445 seconds or 7.42 minutes or 0.12 hours