12 9
68
68 69 60 59 50 41 40 31 22 13 14 5 6 15 16 17 26 25 24 33 34 43 52 53 62 71 70 79 88 97 98 107 106 105 96 87 86 95 94 93 102 101 92 91 90 81 82 83 74 75 76 67 58 57 56 47 38 39 30 21 12 11 2 1 0 9 10 19 28 37 36 45 46 55 64 63 
1 1 1 0 0 1 1 0 0 
1 1 1 1 1 1 1 1 1 
0 1 0 1 1 0 1 1 1 
0 1 0 1 1 0 1 1 0 
1 1 1 1 1 1 0 1 0 
1 1 1 0 0 1 0 1 1 
0 1 1 1 1 1 1 0 1 
1 1 0 0 1 2 1 1 1 
0 0 1 1 1 0 0 1 0 
1 1 1 0 0 1 1 1 0 
1 1 1 1 1 1 1 1 1 
0 0 1 1 0 0 1 1 1 

Complexity: 5
Time: 81893 seconds or 1364.88 minutes or 22.75 hours