11 8
23
23 15 7 6 14 13 21 20 12 4 3 11 10 2 1 9 8 16 17 25 26 27 35 36 37 29 30 38 46 47 55 54 53 52 51 43 42 41 33 32 40 48 49 57 58 59 67 68 69 70 62 63 71 79 78 86 85 84 83 75 74 73 65 64 72 80 
0 1 1 1 1 0 1 1 
1 1 1 1 1 1 1 1 
1 1 0 0 1 1 0 2 
0 1 1 1 0 1 1 0 
1 1 0 1 1 1 1 0 
1 1 1 1 0 0 1 1 
1 1 0 1 1 1 1 1 
0 1 1 1 0 0 1 1 
1 1 0 1 1 1 1 1 
1 1 1 1 0 0 1 1 
1 0 0 1 1 1 1 0 

Complexity: 4
Time: 2752 seconds or 45.87 minutes or 0.76 hours