10 9
55
55 46 45 54 63 72 73 82 83 74 65 66 57 48 49 50 41 42 51 60 59 68 77 76 85 86 87 88 89 80 79 70 71 62 53 44 43 34 35 26 17 16 7 6 15 24 23 14 13 4 3 2 1 10 19 18 27 36 37 38 29 20 21 30 31 
0 1 1 1 1 0 1 1 0 
0 1 0 0 1 1 1 1 1 
1 1 1 1 0 1 1 0 1 
1 0 1 1 1 0 0 1 1 
1 1 1 0 0 1 1 1 1 
1 1 0 1 1 1 1 0 1 
1 2 0 1 0 1 1 0 1 
1 0 1 1 0 1 0 1 1 
1 1 1 0 1 1 0 1 1 
0 1 1 0 1 1 1 1 1 

Complexity: 4
Time: 431 seconds or 7.18 minutes or 0.12 hours