10 9
74
74 83 82 73 64 63 54 45 36 37 38 47 56 57 66 75 76 67 68 77 86 87 88 89 80 79 70 71 62 61 60 51 42 41 50 49 40 31 30 29 20 19 18 9 10 11 2 3 12 13 14 23 24 15 6 7 8 17 26 25 34 43 44 
0 0 1 1 0 0 1 1 1 
1 1 1 1 1 1 1 0 1 
1 1 1 0 0 1 1 1 1 
0 0 1 1 1 0 0 1 0 
1 1 1 0 1 1 1 1 1 
1 0 1 0 1 1 1 0 0 
1 0 1 1 0 0 1 1 1 
1 1 0 1 1 1 0 1 1 
0 1 2 1 1 1 0 1 1 
0 1 1 0 0 1 1 1 1 

Complexity: 4
Time: 4837 seconds or 80.61 minutes or 1.34 hours