9 9
29
29 30 39 40 49 58 59 50 51 52 61 62 71 80 79 70 69 78 77 76 67 66 75 74 73 72 63 64 55 56 47 46 37 36 27 18 19 10 9 0 1 2 11 12 3 4 5 14 15 16 7 8 17 26 35 44 43 34 33 32 23 22 
1 1 1 1 1 1 0 1 1 
1 1 1 1 0 1 1 1 1 
1 1 0 0 1 1 0 0 1 
1 0 2 1 0 1 1 1 1 
1 1 0 1 1 0 0 1 1 
0 1 1 0 1 1 1 1 0 
0 1 1 0 1 1 0 1 1 
1 1 0 1 1 0 1 1 1 
1 1 1 1 1 1 1 1 1 

Complexity: 4
Time: 469 seconds or 7.82 minutes or 0.13 hours