10 8
55
55 47 39 38 46 45 44 36 28 29 30 22 23 15 7 6 5 13 12 4 3 2 10 11 19 27 26 34 42 50 51 52 60 61 62 63 71 70 78 77 76 75 67 66 74 73 72 64 65 57 56 48 40 41 33 25 17 16 8 0 
1 0 1 1 1 1 1 1 
1 0 1 1 1 1 0 1 
1 1 0 1 0 0 1 1 
0 1 1 1 1 1 1 0 
0 1 1 0 1 0 1 1 
1 1 1 0 1 1 1 1 
1 0 1 1 1 0 0 2 
1 1 0 0 1 1 1 1 
1 1 1 1 0 0 1 1 
1 1 1 1 1 1 1 0 

Complexity: 4
Time: 39 seconds or 0.65 minutes or 0.01 hours