9 9
77
77 76 67 66 57 56 65 74 73 72 63 54 45 46 47 38 37 36 27 28 19 20 21 30 31 40 49 50 59 68 69 70 79 80 71 62 53 52 51 42 33 34 35 26 25 16 7 6 15 14 23 22 13 4 3 2 1 10 9 
0 1 1 1 1 0 1 1 0 
1 1 0 0 1 1 1 1 0 
0 1 1 1 1 1 0 1 1 
1 1 0 1 1 0 1 1 1 
1 1 1 0 1 0 1 0 0 
1 1 1 0 1 1 1 1 1 
1 0 1 1 0 1 0 0 1 
1 0 1 1 1 1 1 1 1 
1 1 1 0 1 2 0 1 1 

Complexity: 4
Time: 178 seconds or 2.97 minutes or 0.05 hours