9 9
6
6 7 16 17 26 35 44 53 62 61 70 71 80 79 78 77 68 59 58 57 66 75 74 73 64 63 54 55 46 47 38 37 36 27 28 19 18 9 10 1 2 11 12 21 30 31 32 41 40 49 50 51 52 43 34 25 24 15 14 13 4 
0 1 1 0 1 0 2 1 0 
1 1 1 1 1 1 1 1 1 
1 1 0 1 0 0 1 1 1 
1 1 0 1 1 1 0 1 1 
1 1 1 0 1 1 0 1 1 
0 1 1 0 1 1 1 1 1 
1 1 0 1 1 1 0 1 1 
1 1 0 1 0 1 0 1 1 
0 1 1 1 0 1 1 1 1 

Complexity: 4
Time: 277 seconds or 4.61 minutes or 0.08 hours