11 8
73
73 81 82 74 66 65 64 56 57 49 41 42 34 33 32 24 16 17 18 19 27 28 36 44 43 51 59 67 68 76 84 85 86 78 79 71 70 62 61 53 54 55 47 46 38 39 31 30 29 21 13 14 15 7 6 5 4 3 11 10 9 8 0 
1 0 0 1 1 1 1 1 
1 1 1 1 0 1 1 1 
1 1 1 1 0 1 0 0 
1 0 0 1 1 1 1 1 
1 1 1 0 1 0 1 1 
0 1 1 1 1 0 1 1 
0 1 0 1 0 1 1 1 
1 1 0 1 0 1 1 0 
1 1 1 1 1 0 1 1 
0 2 1 0 1 0 1 1 
0 1 1 0 1 1 1 0 

Complexity: 4
Time: 297 seconds or 4.95 minutes or 0.08 hours