11 8
0
0 1 9 8 16 24 32 33 41 40 48 56 57 65 73 72 80 81 82 83 84 76 75 67 59 58 50 51 52 44 43 35 27 26 18 10 11 3 4 5 6 14 15 23 22 21 20 28 29 37 38 39 47 46 54 55 63 62 61 69 77 78 79 87 
2 1 0 1 1 1 1 0 
1 1 1 1 0 0 1 1 
1 0 1 0 1 1 1 1 
1 0 1 1 1 1 0 0 
1 1 0 1 0 1 1 1 
1 1 0 1 1 0 1 1 
1 0 1 1 1 0 1 1 
1 1 1 1 0 1 1 1 
0 1 0 1 0 1 0 0 
1 1 0 1 1 1 1 1 
1 1 1 1 1 0 0 1 

Complexity: 4
Time: 1775 seconds or 29.58 minutes or 0.49 hours