10 9
24
24 23 32 33 42 51 52 61 62 53 44 35 26 25 16 7 6 5 4 13 12 3 2 1 10 9 18 27 36 37 46 55 64 63 72 73 82 83 84 85 76 75 66 57 56 47 38 29 20 21 30 31 40 49 58 59 68 69 78 87 88 79 80 
0 1 1 1 1 1 1 1 0 
1 1 0 1 1 0 0 1 0 
1 0 1 1 0 1 2 1 1 
1 0 1 1 1 1 1 0 1 
1 1 1 0 1 0 1 0 1 
0 1 1 0 1 0 1 1 1 
0 1 1 1 1 1 0 1 1 
1 1 0 1 0 1 1 0 0 
1 1 0 1 1 0 1 1 1 
0 1 1 1 1 0 1 1 0 

Complexity: 4
Time: 58 seconds or 0.97 minutes or 0.02 hours