11 8
36
36 28 29 37 45 46 54 62 70 69 68 60 52 51 43 35 34 26 18 19 11 12 13 5 4 3 2 1 9 17 16 24 32 40 41 49 57 58 66 65 64 72 80 81 82 74 75 76 84 85 86 87 79 71 63 55 47 39 31 23 22 14 15 7 
0 1 1 1 1 1 0 1 
0 1 0 1 1 1 1 1 
1 1 1 1 0 0 1 1 
1 0 1 0 1 1 0 1 
1 0 1 1 2 1 0 1 
1 1 0 1 0 1 1 1 
0 1 0 1 1 0 1 1 
0 1 1 0 1 0 1 1 
1 1 1 0 1 1 1 1 
1 0 1 1 1 0 0 1 
1 1 1 0 1 1 1 1 

Complexity: 4
Time: 715 seconds or 11.91 minutes or 0.2 hours