9 9
77
77 68 67 76 75 74 73 64 63 54 45 36 27 28 37 38 47 56 57 58 59 60 51 50 41 40 39 30 21 20 19 10 9 0 1 2 3 4 13 22 23 14 15 16 7 8 17 26 35 34 33 42 43 44 53 62 71 70 69 78 
1 1 1 1 1 0 0 1 1 
1 1 0 0 1 1 1 1 1 
0 1 1 1 1 1 0 0 1 
1 1 0 1 0 0 1 1 1 
1 1 1 1 1 1 1 1 1 
1 0 1 0 0 1 1 0 1 
1 0 1 1 1 1 1 0 1 
1 1 0 0 1 1 1 1 1 
0 1 1 1 1 2 1 0 0 

Complexity: 4
Time: 126 seconds or 2.1 minutes or 0.04 hours