11 8
22
22 21 29 30 38 39 31 23 15 7 6 5 13 12 20 19 11 10 2 1 9 8 16 24 25 26 34 35 36 44 45 53 54 55 63 62 70 71 79 78 86 85 77 76 68 60 52 51 50 42 41 40 48 56 57 58 66 74 75 83 82 81 73 72 
0 1 1 0 0 1 1 1 
1 1 1 1 1 1 0 1 
1 0 0 1 1 1 2 1 
1 1 1 0 0 1 1 1 
0 0 1 1 1 0 1 1 
1 1 1 0 1 1 0 0 
1 0 1 1 1 1 1 1 
1 1 1 0 1 0 1 1 
0 0 1 0 1 0 1 1 
1 1 1 1 1 1 1 1 
0 1 1 1 0 1 1 0 

Complexity: 4
Time: 273 seconds or 4.55 minutes or 0.08 hours