9 9
66
66 65 74 73 64 63 54 55 46 47 48 39 38 37 36 27 18 9 0 1 10 19 20 21 30 31 32 41 42 51 50 59 58 67 68 77 78 79 70 61 62 53 44 35 34 25 24 15 16 17 8 7 6 5 14 13 12 3 
1 1 0 1 0 1 1 1 1 
1 1 0 1 1 1 1 1 1 
1 1 1 1 0 0 1 1 0 
1 0 0 1 1 1 0 1 1 
1 1 1 1 0 1 1 0 1 
0 1 1 1 0 1 1 0 1 
1 1 0 0 1 1 0 1 1 
1 1 1 2 1 1 0 1 0 
0 1 1 0 0 1 1 1 0 

Complexity: 4
Time: 26 seconds or 0.44 minutes or 0.01 hours