10 9
56
56 57 48 39 38 37 28 19 20 21 22 31 40 49 50 41 42 51 60 61 52 53 62 71 80 89 88 79 78 87 86 77 68 67 76 75 74 83 82 81 72 73 64 55 54 45 36 27 18 9 10 1 2 3 4 13 14 5 6 7 8 17 16 25 24 33 34 35 
0 1 1 1 1 1 1 1 1 
1 1 0 0 1 1 0 1 1 
1 1 1 1 1 0 1 1 0 
1 1 0 0 1 0 1 1 1 
1 1 1 1 1 1 1 0 0 
1 0 0 1 1 1 1 1 1 
1 1 2 1 0 0 1 1 1 
0 1 0 0 1 1 0 0 1 
1 1 1 1 1 1 1 1 1 
1 1 1 0 0 1 1 1 1 

Complexity: 4
Time: 907 seconds or 15.12 minutes or 0.25 hours