9 9
38
38 37 46 45 54 63 72 73 64 55 56 47 48 49 40 41 50 59 68 67 66 75 76 77 78 69 70 71 62 53 52 51 42 33 34 35 26 17 8 7 6 15 24 23 22 13 4 3 2 11 12 21 30 29 28 19 18 9 0 
1 0 1 1 1 0 1 1 1 
1 0 1 1 1 0 1 0 1 
1 1 0 1 1 1 1 0 1 
0 1 1 1 0 0 1 1 1 
0 1 2 0 1 1 1 0 0 
1 1 1 1 1 1 1 1 1 
1 1 1 0 0 1 0 0 1 
1 1 0 1 1 1 1 1 1 
1 1 0 1 1 1 1 0 0 

Complexity: 4
Time: 192 seconds or 3.21 minutes or 0.05 hours