10 9
24
24 33 32 31 40 49 48 47 56 65 64 73 82 81 72 63 54 45 36 37 38 29 28 27 18 19 10 1 2 3 12 21 22 13 14 15 6 7 8 17 26 35 34 43 52 51 50 59 68 67 66 75 84 85 86 77 78 79 70 61 62 71 80 89 
0 1 1 1 0 0 1 1 1 
0 1 0 1 1 1 1 0 1 
1 1 0 1 1 0 2 0 1 
1 1 1 0 1 1 1 1 1 
1 1 1 0 1 0 0 1 0 
1 0 1 1 1 1 1 1 0 
1 0 1 0 0 1 0 1 1 
1 1 1 1 1 1 0 1 1 
1 1 0 1 0 1 1 1 1 
1 1 0 1 1 1 0 0 1 

Complexity: 4
Time: 765 seconds or 12.76 minutes or 0.21 hours