10 8
59
59 51 43 42 34 26 27 19 20 21 29 28 36 44 52 53 61 69 70 78 79 71 63 55 47 46 38 39 31 23 22 14 6 5 4 12 11 10 2 1 0 8 9 17 16 24 32 40 41 49 50 58 57 56 64 65 73 74 66 67 75 76 
1 1 1 0 1 1 1 0 
1 1 1 1 1 0 1 0 
1 1 0 1 1 1 1 1 
1 0 1 1 1 1 0 1 
1 0 1 0 1 0 1 1 
1 1 1 1 1 0 1 1 
0 1 1 1 1 1 0 1 
1 1 1 2 0 1 0 1 
1 1 1 1 0 1 1 1 
0 1 1 1 1 0 1 1 

Complexity: 4
Time: 1705 seconds or 28.42 minutes or 0.47 hours