9 9
9
9 18 27 36 37 28 19 20 11 10 1 2 3 12 13 14 5 6 7 8 17 26 35 44 53 62 61 60 51 52 43 34 25 24 23 32 41 40 31 30 39 48 47 56 55 54 63 64 73 74 75 66 67 58 59 68 69 78 79 80 
0 1 1 1 0 1 1 1 1 
2 1 1 1 1 1 0 0 1 
1 1 1 0 0 1 1 1 1 
1 1 0 1 1 1 0 1 1 
1 1 0 1 1 1 0 1 1 
0 0 1 1 0 0 1 1 1 
1 1 1 0 1 1 1 1 1 
1 1 0 1 1 1 1 0 0 
0 1 1 1 0 0 1 1 1 

Complexity: 4
Time: 96 seconds or 1.61 minutes or 0.03 hours