9 9
29
29 30 39 38 37 46 55 56 57 58 49 50 51 42 41 32 23 22 13 14 15 6 7 8 17 26 25 34 35 44 53 62 61 60 69 70 79 78 77 76 67 66 75 74 73 72 63 54 45 36 27 28 19 10 11 12 3 2 1 0 
1 1 1 1 0 0 1 1 1 
0 1 1 1 1 1 1 0 1 
0 1 0 0 1 1 0 1 1 
1 1 2 1 0 1 0 1 1 
1 1 1 1 0 1 1 0 1 
1 1 0 0 1 1 1 0 1 
1 1 1 1 1 0 1 1 1 
1 0 0 1 1 0 1 1 0 
1 1 1 1 1 1 1 1 0 

Complexity: 4
Time: 759 seconds or 12.64 minutes or 0.21 hours