10 9
18
18 9 10 1 2 3 12 21 20 19 28 37 38 39 40 31 22 23 14 5 6 7 8 17 16 25 34 33 42 43 44 53 52 61 62 71 80 89 88 79 70 69 68 59 50 49 58 57 48 47 46 45 54 63 64 65 74 73 82 83 84 75 76 77 86 
0 1 1 1 0 1 1 1 1 
1 1 0 1 0 1 0 1 1 
2 1 1 1 1 1 0 1 0 
0 1 0 0 1 0 1 1 0 
0 1 1 1 1 0 1 1 1 
1 1 1 1 1 1 0 1 1 
1 0 0 1 1 1 0 1 1 
1 1 1 0 0 1 1 1 1 
0 1 1 1 1 1 0 1 1 
0 1 1 1 0 1 0 1 1 

Complexity: 4
Time: 4104 seconds or 68.4 minutes or 1.14 hours