10 8
47
47 55 54 46 45 37 38 39 31 30 22 14 13 12 20 28 27 35 43 42 50 51 52 60 61 62 70 71 79 78 77 76 75 67 66 74 73 72 64 56 57 49 48 40 32 33 25 24 16 8 0 1 9 17 18 10 11 3 4 5 6 7 
1 1 0 1 1 1 1 1 
1 1 1 1 1 1 1 0 
1 1 1 0 1 0 1 0 
1 1 0 1 1 0 1 1 
1 1 0 1 0 1 1 1 
1 0 1 1 0 1 1 2 
1 1 1 1 1 0 1 1 
1 1 0 0 1 1 1 0 
1 0 1 1 0 0 1 1 
1 1 1 1 1 1 1 1 

Complexity: 4
Time: 343 seconds or 5.72 minutes or 0.1 hours