11 8
17
17 16 8 9 1 2 3 4 12 11 19 27 26 34 33 32 40 48 49 50 58 57 65 64 72 73 81 82 83 84 76 75 67 68 60 52 44 43 35 36 37 29 21 22 14 6 7 15 23 31 39 47 46 54 55 63 62 61 69 70 78 86 87 
0 1 1 1 1 0 1 1 
1 1 0 1 1 0 1 1 
1 2 0 1 0 1 1 1 
0 0 1 1 0 1 0 1 
1 1 1 1 1 1 0 1 
1 0 0 1 1 0 1 1 
1 1 1 0 1 0 1 1 
0 1 1 0 1 1 1 1 
1 1 0 1 1 1 1 0 
1 1 0 1 1 0 1 0 
0 1 1 1 1 0 1 1 

Complexity: 4
Time: 2119 seconds or 35.32 minutes or 0.59 hours