11 8
4
4 5 13 12 11 3 2 1 0 8 16 17 18 26 25 33 32 40 48 56 64 72 80 81 82 74 73 65 57 49 50 42 43 35 36 28 20 21 22 14 15 23 31 39 38 37 45 44 52 60 59 67 68 76 84 85 77 69 70 62 54 55 63 71 79 87 
1 1 1 1 2 1 0 0 
1 0 0 1 1 1 1 1 
1 1 1 0 1 1 1 1 
0 1 1 0 1 0 0 1 
1 1 0 1 1 1 1 1 
1 0 1 1 1 1 0 0 
1 1 1 0 1 0 1 1 
1 1 0 1 1 0 1 1 
1 1 0 1 1 1 1 1 
1 1 1 0 1 1 0 1 
1 1 1 0 1 1 0 1 

Complexity: 4
Time: 236 seconds or 3.93 minutes or 0.07 hours