11 8
54
54 53 45 46 38 30 31 39 47 55 63 71 79 87 86 78 70 69 61 60 59 67 66 74 75 76 84 83 82 81 80 72 64 56 57 49 50 51 43 35 36 28 20 21 13 14 15 7 6 5 4 3 11 10 2 1 9 8 16 17 18 26 25 33 41 40 
0 1 1 1 1 1 1 1 
1 1 1 1 0 1 1 1 
1 1 1 0 1 1 0 0 
0 1 1 0 1 0 1 1 
0 1 0 1 1 0 1 1 
1 1 0 1 0 1 1 1 
0 1 1 1 0 1 2 1 
1 1 0 1 1 1 0 1 
1 0 1 1 0 1 1 1 
1 0 1 1 1 0 1 1 
1 1 1 1 1 0 1 1 

Complexity: 4
Time: 1185 seconds or 19.75 minutes or 0.33 hours