10 9
13
13 4 5 6 15 16 17 26 25 34 43 52 53 62 71 80 79 88 87 86 77 68 69 60 51 42 41 32 23 22 21 30 39 40 49 58 67 66 75 84 83 82 73 72 63 64 55 56 47 46 45 36 37 28 19 20 11 2 1 10 9 
0 1 1 0 1 1 1 0 0 
1 1 1 0 2 0 1 1 1 
0 1 1 1 1 1 0 1 1 
0 1 0 1 0 1 0 1 0 
1 1 0 1 1 1 1 1 0 
1 1 1 0 1 0 1 1 1 
0 1 1 0 1 0 1 0 1 
1 1 0 1 1 1 1 0 1 
1 1 0 1 0 1 0 1 1 
0 1 1 1 0 1 1 1 0 

Complexity: 4
Time: 1983 seconds or 33.05 minutes or 0.55 hours