10 8
67
67 68 60 52 51 43 35 34 26 18 17 9 1 0 8 16 24 32 40 41 49 57 58 66 65 64 72 73 74 75 76 77 69 70 71 63 62 54 55 47 46 45 37 36 28 20 19 11 3 4 5 13 14 22 30 31 23 15 7 
1 1 0 1 1 1 0 1 
1 1 0 1 0 1 1 1 
1 1 1 1 1 0 1 1 
1 0 1 0 1 0 1 1 
1 0 1 1 1 1 0 0 
1 1 0 1 0 1 1 1 
0 1 0 1 1 0 1 1 
0 1 1 0 1 0 1 1 
1 1 1 2 1 1 1 1 
1 1 1 1 1 1 0 0 

Complexity: 4
Time: 142 seconds or 2.37 minutes or 0.04 hours