9 9
5
5 6 15 16 7 8 17 26 35 44 43 34 33 32 23 14 13 4 3 2 1 0 9 10 11 20 21 30 39 40 49 58 59 50 51 52 61 62 71 80 79 70 69 78 77 76 75 66 65 56 47 46 37 28 27 36 45 54 55 64 73 
1 1 1 1 1 2 1 1 1 
1 1 1 0 1 1 1 1 1 
0 0 1 1 0 1 0 0 1 
1 1 0 1 0 1 1 1 1 
1 1 0 1 1 0 0 1 1 
1 1 1 0 1 1 1 1 0 
1 1 1 0 1 1 0 1 1 
0 1 1 1 0 0 1 1 1 
0 1 0 1 1 1 1 1 1 

Complexity: 4
Time: 55 seconds or 0.92 minutes or 0.02 hours