10 9
50
50 41 40 39 30 21 20 11 2 1 10 9 18 19 28 37 36 45 46 47 56 55 54 63 72 73 74 83 84 75 66 57 58 67 76 77 78 87 88 79 80 71 70 69 60 51 52 53 44 35 34 33 24 23 22 13 4 5 6 7 16 17 
0 1 1 0 1 1 1 1 0 
1 1 1 0 1 0 0 1 1 
1 1 1 1 1 1 1 0 0 
0 1 0 1 0 0 1 1 1 
1 1 0 1 1 1 0 0 1 
1 1 1 0 0 2 1 1 1 
1 1 1 1 1 0 1 0 0 
1 0 0 1 1 0 1 1 1 
1 1 1 1 1 1 1 1 1 
0 0 1 1 0 0 1 1 0 

Complexity: 4
Time: 3533 seconds or 58.88 minutes or 0.98 hours