10 9
24
24 23 22 31 40 39 48 47 38 29 20 19 18 27 36 37 46 55 56 65 64 63 72 73 82 83 84 75 76 85 86 87 88 79 80 71 62 61 60 69 68 67 58 59 50 51 52 43 42 33 34 35 26 17 16 15 6 5 4 13 12 11 2 1 0 
1 1 1 0 1 1 1 0 0 
0 0 1 1 1 0 1 1 1 
1 1 1 0 1 1 2 0 1 
1 0 1 0 1 0 1 1 1 
1 1 1 1 1 0 1 1 0 
0 1 1 1 0 1 1 1 0 
0 1 1 0 1 1 1 1 1 
1 1 1 0 1 1 1 0 1 
1 1 0 1 1 0 0 1 1 
0 1 1 1 1 1 1 1 0 

Complexity: 4
Time: 1755 seconds or 29.25 minutes or 0.49 hours