10 8
28
28 36 35 34 33 25 24 32 40 41 42 50 49 48 56 64 65 66 74 75 67 59 60 52 44 45 46 54 62 70 69 77 78 79 71 63 55 47 39 31 30 29 21 13 14 15 7 6 5 4 3 11 19 18 10 9 8 0 
1 0 0 1 1 1 1 1 
1 1 1 1 0 1 1 1 
0 0 1 1 0 1 0 0 
1 1 0 0 2 1 1 1 
1 1 1 1 1 0 0 1 
1 1 1 0 1 1 1 1 
1 1 1 0 1 0 1 1 
1 0 0 1 1 0 1 1 
1 1 1 1 0 1 1 1 
0 0 1 1 0 1 1 1 

Complexity: 4
Time: 264 seconds or 4.4 minutes or 0.07 hours