9 9
71
71 80 79 78 77 68 67 76 75 74 73 72 63 64 65 56 57 48 47 46 45 36 37 28 19 18 9 0 1 2 3 4 5 6 15 16 7 8 17 26 25 34 33 24 23 22 13 12 21 20 29 30 31 40 41 50 59 60 61 52 43 44 
1 1 1 1 1 1 1 1 1 
1 0 0 1 1 0 1 1 1 
1 1 1 1 1 1 1 1 1 
0 1 1 1 1 0 1 1 0 
1 1 0 0 1 1 0 1 1 
1 1 1 1 0 1 0 1 0 
0 0 1 1 0 1 1 1 0 
1 1 1 0 1 1 0 0 2 
1 1 1 1 1 1 1 1 1 

Complexity: 4
Time: 834 seconds or 13.89 minutes or 0.23 hours