10 9
19
19 10 9 18 27 36 45 54 55 46 37 28 29 30 39 40 41 50 49 48 57 56 65 74 73 72 81 82 83 84 75 76 67 68 77 78 87 88 79 80 71 70 69 60 51 52 53 44 35 34 33 24 23 22 13 12 11 2 3 4 5 6 15 16 17 8 
0 0 1 1 1 1 1 0 1 
1 1 1 1 1 0 1 1 1 
1 2 0 0 1 1 1 0 0 
1 1 1 1 0 0 1 1 1 
1 1 0 1 1 1 0 0 1 
1 1 0 1 1 1 1 1 1 
1 1 1 1 0 0 1 0 0 
0 0 1 0 1 1 1 1 1 
1 1 1 1 1 1 1 1 1 
1 1 1 1 0 0 1 1 0 

Complexity: 4
Time: 203 seconds or 3.38 minutes or 0.06 hours