9 9
41
41 32 33 42 43 44 35 26 25 16 7 6 15 14 5 4 3 2 11 12 13 22 31 30 29 38 47 56 57 48 49 50 51 60 61 62 71 80 79 78 77 68 67 76 75 74 73 64 63 54 45 36 37 28 19 10 9 0 
1 0 1 1 1 1 1 1 0 
1 1 1 1 1 1 1 1 0 
0 1 0 0 1 0 0 1 1 
0 1 1 1 1 1 1 0 1 
1 1 1 0 0 2 1 1 1 
1 0 1 1 1 1 1 0 0 
1 0 1 1 0 0 1 1 1 
1 1 0 0 1 1 0 0 1 
0 1 1 1 1 1 1 1 1 

Complexity: 4
Time: 206 seconds or 3.43 minutes or 0.06 hours