10 9
70
70 71 62 53 44 35 26 17 8 7 6 5 14 13 4 3 2 11 10 9 18 19 20 21 30 29 28 37 46 45 54 63 72 73 82 83 84 85 76 67 66 65 56 47 48 49 40 41 32 23 24 25 34 43 52 51 60 59 68 77 78 87 88 89 
0 0 1 1 1 1 1 1 1 
1 1 1 0 1 1 0 0 1 
1 1 1 1 0 1 1 1 1 
0 1 1 1 0 1 0 1 1 
0 1 0 0 1 1 0 1 1 
1 1 1 1 1 0 1 1 1 
1 0 1 0 0 1 1 0 1 
1 0 1 1 1 1 0 2 1 
1 1 0 0 1 1 1 0 0 
0 1 1 1 1 0 1 1 1 

Complexity: 4
Time: 1681 seconds or 28.01 minutes or 0.47 hours