10 9
61
61 60 59 50 41 40 31 22 21 30 39 38 37 28 19 18 9 10 11 2 3 4 5 14 15 16 7 8 17 26 25 24 33 34 43 52 53 62 71 80 89 88 79 78 77 68 67 58 57 56 47 46 45 54 55 64 63 72 81 82 83 74 75 76 85 
0 0 1 1 1 1 0 1 1 
1 1 1 0 0 1 1 1 1 
1 1 0 1 1 0 1 1 1 
0 1 0 1 1 0 1 1 0 
0 1 1 1 1 1 0 1 0 
1 1 1 0 0 1 0 1 1 
1 1 1 1 1 1 1 2 1 
1 1 0 0 1 1 0 0 1 
1 0 1 1 1 1 1 1 1 
1 1 1 0 1 0 0 1 1 

Complexity: 4
Time: 587 seconds or 9.79 minutes or 0.16 hours