9 9
21
21 30 39 40 41 32 23 24 25 26 17 16 7 6 5 14 13 12 11 2 1 10 9 18 19 28 37 38 47 56 55 46 45 54 63 72 73 74 75 66 57 58 59 50 51 52 43 34 35 44 53 62 71 80 79 70 69 68 77 
0 1 1 0 0 1 1 1 0 
1 1 1 1 1 1 0 1 1 
1 1 0 2 0 1 1 1 1 
0 1 0 1 0 1 0 1 1 
0 1 1 1 1 1 0 1 1 
1 1 1 0 0 1 1 1 1 
1 1 1 1 1 1 0 0 1 
1 0 0 1 0 1 1 1 1 
1 1 1 1 0 1 0 1 1 

Complexity: 4
Time: 305 seconds or 5.08 minutes or 0.08 hours