11 8
57
57 56 64 72 73 81 82 83 84 76 68 67 66 58 50 51 52 44 36 28 27 26 34 42 41 40 32 24 16 8 0 1 9 17 18 19 11 3 4 5 6 14 13 21 22 23 31 39 38 37 45 46 47 55 63 62 61 69 77 85 86 87 79 71 
1 1 0 1 1 1 1 0 
1 1 0 1 0 1 1 0 
1 1 1 1 0 1 1 1 
1 0 1 1 1 0 0 1 
1 0 1 0 1 1 1 1 
1 1 1 0 1 1 1 1 
0 0 1 1 1 0 0 1 
1 2 1 0 0 1 1 1 
1 0 1 1 1 1 0 1 
1 1 0 0 1 1 0 1 
0 1 1 1 1 1 1 1 

Complexity: 4
Time: 153 seconds or 2.55 minutes or 0.04 hours