10 9
15
15 6 5 4 13 12 21 20 11 2 1 0 9 18 27 28 37 46 47 56 65 64 55 54 63 72 81 82 83 84 75 66 67 76 85 86 77 78 87 88 79 70 71 62 53 44 35 34 43 42 51 60 59 50 49 48 39 30 31 32 23 24 25 16 17 8 
1 1 1 0 1 1 1 0 1 
1 0 1 1 1 0 2 1 1 
1 0 1 1 0 1 1 1 0 
1 1 0 1 1 1 0 1 1 
0 1 0 1 0 0 1 1 1 
0 1 1 1 1 1 1 0 1 
1 1 1 0 0 1 1 0 1 
1 1 1 1 1 0 0 1 1 
1 0 0 1 1 1 1 1 0 
1 1 1 1 1 1 1 1 0 

Complexity: 4
Time: 1126 seconds or 18.76 minutes or 0.31 hours