10 8
50
50 58 57 56 64 72 73 74 75 67 68 76 77 78 79 71 70 69 61 60 52 44 43 35 34 33 41 40 32 24 16 8 9 17 18 19 27 28 36 37 38 46 54 55 47 39 31 23 15 7 6 14 22 21 13 12 4 3 2 
0 0 1 1 1 0 1 1 
1 1 0 0 1 1 1 1 
1 1 1 1 0 1 1 1 
1 0 0 1 1 0 0 1 
1 1 1 1 1 1 1 1 
1 1 0 1 1 0 1 1 
0 0 2 0 1 0 1 1 
1 1 1 0 1 1 0 0 
1 0 0 1 1 1 1 1 
1 1 1 1 1 1 1 1 

Complexity: 4
Time: 240 seconds or 4.01 minutes or 0.07 hours