10 9
49
49 50 59 60 69 70 71 80 89 88 87 78 77 68 67 76 75 84 83 82 73 72 63 64 65 56 57 48 39 38 37 46 45 36 27 28 19 20 21 22 31 32 33 42 43 52 53 44 35 34 25 16 17 8 7 6 15 14 5 4 3 2 11 10 9 
0 0 1 1 1 1 1 1 1 
1 1 1 0 0 1 1 1 1 
0 1 1 1 1 0 0 1 0 
1 1 0 0 1 1 1 1 1 
1 1 1 1 0 0 1 1 1 
1 1 0 1 2 1 0 1 1 
0 0 1 1 0 1 1 0 0 
1 1 1 0 1 1 1 1 1 
1 1 0 1 1 1 1 0 1 
0 1 1 1 0 0 1 1 1 

Complexity: 4
Time: 1489 seconds or 24.82 minutes or 0.41 hours