11 8
77
77 69 61 53 52 44 36 37 29 21 22 23 15 7 6 5 4 12 11 3 2 1 0 8 16 24 25 17 18 19 27 35 34 42 41 40 48 49 50 58 59 67 66 65 64 72 80 81 82 83 75 76 84 85 86 78 79 71 63 62 54 46 38 39 
1 1 1 1 1 1 1 1 
1 0 0 1 1 0 0 1 
1 1 1 1 0 1 1 1 
1 1 0 1 0 1 0 0 
0 0 1 1 1 1 1 1 
1 1 1 0 1 0 1 0 
1 1 1 0 1 1 1 0 
0 0 1 1 0 1 1 1 
1 1 1 1 0 1 0 1 
1 0 0 1 1 2 1 1 
1 1 1 1 1 1 1 0 

Complexity: 4
Time: 661 seconds or 11.01 minutes or 0.18 hours