10 8
32
32 33 25 24 16 8 9 1 2 3 11 10 18 19 27 35 36 28 20 21 13 5 6 7 15 14 22 30 38 39 47 55 63 62 54 46 45 44 52 60 59 58 50 42 41 40 48 56 64 65 73 74 75 67 68 69 77 78 79 
0 1 1 1 0 1 1 1 
1 1 1 1 0 1 1 1 
1 0 1 1 1 1 1 0 
1 1 0 1 1 0 1 0 
2 1 0 1 1 0 1 1 
1 1 1 0 1 1 1 1 
1 0 1 0 1 0 1 1 
1 0 1 1 1 0 1 1 
1 1 0 1 1 1 0 0 
0 1 1 1 0 1 1 1 

Complexity: 4
Time: 402 seconds or 6.7 minutes or 0.11 hours