10 9
71
71 70 79 88 87 86 85 76 77 68 59 60 51 52 53 44 43 34 33 24 25 26 17 8 7 6 5 14 13 12 11 2 1 10 19 18 27 36 45 54 63 64 55 46 47 38 29 30 21 22 31 32 41 40 49 58 57 66 65 74 83 82 81 
0 1 1 0 0 1 1 1 1 
0 1 1 1 1 1 0 0 1 
1 1 0 1 1 0 1 1 1 
1 0 1 1 1 1 1 1 0 
1 0 1 0 1 1 0 1 1 
1 1 1 0 1 0 1 1 1 
1 1 0 1 1 1 1 0 0 
1 1 1 1 0 1 0 1 2 
0 0 1 0 1 1 0 1 0 
1 1 1 0 1 1 1 1 0 

Complexity: 4
Time: 1317 seconds or 21.94 minutes or 0.37 hours