9 9
31
31 22 23 24 15 14 5 6 7 8 17 26 35 34 43 42 41 50 51 52 61 62 71 80 79 78 69 68 77 76 75 66 67 58 49 48 39 30 29 20 21 12 3 2 1 10 9 18 27 36 37 46 45 54 63 72 73 64 55 56 
0 1 1 1 0 1 1 1 1 
1 1 0 1 0 1 1 0 1 
1 0 1 1 1 1 1 0 1 
1 0 1 1 2 0 0 1 1 
1 1 0 1 0 1 1 1 0 
1 1 0 1 1 1 1 1 0 
1 1 1 0 1 0 0 1 1 
1 1 0 1 1 1 1 0 1 
1 1 0 1 1 1 1 1 1 

Complexity: 4
Time: 161 seconds or 2.68 minutes or 0.04 hours