11 8
10
10 11 19 18 26 25 33 32 24 16 8 0 1 2 3 4 12 13 5 6 7 15 23 22 30 38 39 47 55 63 62 70 78 79 87 86 85 77 69 68 60 59 51 52 53 45 37 29 28 36 35 43 42 41 49 57 56 64 65 66 74 75 83 82 81 80 
1 1 1 1 1 1 1 1 
1 0 2 1 1 1 0 1 
1 0 1 1 0 0 1 1 
1 1 1 0 1 1 1 0 
1 1 0 1 1 1 1 1 
0 1 1 1 0 1 0 1 
0 1 0 1 1 1 0 1 
1 1 0 1 1 0 1 1 
1 1 1 0 1 1 1 0 
0 0 1 1 0 1 1 1 
1 1 1 1 0 1 1 1 

Complexity: 4
Time: 257 seconds or 4.28 minutes or 0.07 hours