11 8
81
81 80 72 73 65 57 49 48 40 32 33 41 42 50 58 59 60 68 76 75 74 82 83 84 85 77 78 86 87 79 71 63 62 61 53 52 44 36 35 27 26 18 17 16 8 0 1 2 10 11 19 20 12 13 5 6 7 15 23 22 30 29 37 38 46 47 
1 1 1 0 0 1 1 1 
1 0 1 1 1 1 0 1 
1 1 1 1 1 0 1 1 
0 0 1 1 0 1 1 0 
1 1 0 1 1 1 1 0 
1 1 1 0 1 0 1 1 
1 1 1 0 1 1 0 0 
0 1 1 1 1 1 1 1 
0 1 0 0 1 0 0 1 
1 1 1 1 1 1 1 1 
1 2 1 1 1 1 1 1 

Complexity: 4
Time: 87 seconds or 1.45 minutes or 0.02 hours