9 9
70
70 61 52 51 42 41 32 23 24 15 6 7 8 17 26 25 34 35 44 53 62 71 80 79 78 77 68 59 58 49 40 39 30 21 12 13 4 3 2 1 10 9 18 19 28 29 38 47 56 65 66 75 74 73 64 55 54 45 36 
0 1 1 1 1 0 1 1 1 
1 1 0 1 1 0 1 0 1 
1 1 0 1 0 1 1 1 1 
0 1 1 1 0 1 0 1 1 
1 0 1 1 1 1 1 0 1 
1 0 1 0 1 0 1 1 1 
1 1 1 0 1 1 0 1 1 
0 1 1 1 0 1 0 2 1 
0 1 1 1 0 1 1 1 1 

Complexity: 4
Time: 20 seconds or 0.33 minutes or 0.01 hours