10 9
1
1 10 9 18 19 20 21 12 3 4 5 14 15 24 23 22 31 40 41 42 51 60 59 58 67 66 57 48 47 38 29 28 37 46 45 54 63 64 65 74 73 82 83 84 85 86 77 78 87 88 89 80 79 70 61 52 53 44 43 34 25 16 17 8 
0 2 0 1 1 1 0 0 1 
1 1 0 1 0 1 1 1 1 
1 1 1 1 1 1 1 1 0 
0 1 1 0 1 0 0 1 0 
0 1 1 0 1 1 1 1 1 
1 1 1 1 0 0 1 1 1 
1 0 0 1 1 1 1 1 0 
1 1 1 1 1 0 0 1 0 
0 1 1 0 0 1 1 1 1 
0 1 1 1 1 1 1 1 1 

Complexity: 4
Time: 330 seconds or 5.5 minutes or 0.09 hours