9 9
10
10 1 0 9 18 27 28 37 36 45 46 47 56 55 54 63 72 73 74 75 66 57 58 49 50 59 68 77 78 69 60 61 70 71 62 53 44 43 42 33 34 35 26 17 8 7 6 15 24 23 22 31 40 39 30 21 20 11 12 13 4 
1 1 0 0 1 0 1 1 1 
1 2 1 1 1 0 1 0 1 
1 0 1 1 1 1 1 0 1 
1 1 0 1 1 0 1 1 1 
1 1 0 1 1 0 1 1 1 
1 1 1 0 1 1 0 0 1 
1 1 1 1 1 1 1 1 1 
1 0 0 1 0 1 1 1 1 
1 1 1 1 0 1 1 0 0 

Complexity: 4
Time: 221 seconds or 3.69 minutes or 0.06 hours