11 8
26
26 27 35 43 51 52 44 36 28 29 21 20 12 4 3 11 10 2 1 0 8 9 17 16 24 32 33 41 40 48 49 50 58 57 65 73 72 80 81 82 74 75 67 68 76 77 85 86 78 79 71 63 62 61 53 54 46 38 39 31 23 15 14 6 
1 1 1 1 1 0 1 0 
1 1 1 1 1 0 1 1 
1 1 0 0 1 1 0 1 
1 0 2 1 1 1 0 1 
1 1 0 1 1 0 1 1 
1 1 0 1 1 0 1 0 
1 1 1 1 1 1 1 0 
0 1 1 0 0 1 1 1 
0 1 0 1 1 0 0 1 
1 1 1 1 1 1 1 1 
1 1 1 0 0 1 1 0 

Complexity: 4
Time: 511 seconds or 8.51 minutes or 0.14 hours