10 8
39
39 47 46 54 62 63 71 70 69 77 76 75 67 66 74 73 65 64 56 57 58 50 51 52 60 61 53 45 44 36 37 29 30 31 23 15 7 6 14 13 5 4 3 2 10 11 12 20 28 27 26 34 42 41 40 32 24 25 17 16 8 0 
1 0 1 1 1 1 1 1 
1 0 1 1 1 1 1 1 
1 1 0 0 1 0 0 1 
1 1 1 1 1 1 1 1 
1 0 1 0 1 1 0 2 
1 1 1 0 1 1 1 1 
0 0 1 1 1 1 1 0 
1 1 1 0 1 1 1 1 
1 1 1 1 0 1 1 1 
0 1 1 1 1 1 0 0 

Complexity: 4
Time: 617 seconds or 10.29 minutes or 0.17 hours