10 9
43
43 44 35 26 17 16 15 6 5 4 13 14 23 24 33 42 51 50 59 68 67 66 57 48 47 38 39 40 31 30 21 20 11 2 1 0 9 10 19 28 27 36 45 46 55 64 63 72 73 74 83 84 85 86 77 78 79 70 61 62 71 80 89 
1 1 1 0 1 1 1 0 0 
1 1 1 0 1 1 1 1 1 
0 1 1 1 0 1 1 0 1 
1 1 0 1 1 0 1 0 1 
1 0 1 1 1 0 1 2 1 
1 1 1 1 0 1 1 0 0 
0 1 0 1 0 1 0 1 1 
1 1 0 1 1 1 0 1 1 
1 1 1 0 0 1 1 1 1 
0 0 1 1 1 1 0 0 1 

Complexity: 4
Time: 358 seconds or 5.96 minutes or 0.1 hours