10 9
42
42 33 34 35 26 17 8 7 16 15 6 5 4 13 12 11 10 1 0 9 18 27 28 29 38 39 30 21 22 23 32 41 50 49 58 67 66 57 56 55 46 45 54 63 72 81 82 73 74 75 84 85 86 77 78 87 88 89 80 71 70 69 60 51 52 53 
1 1 0 0 1 1 1 1 1 
1 1 1 1 1 0 1 1 1 
1 0 0 1 1 1 0 0 1 
1 1 1 1 0 1 1 1 1 
0 0 1 1 0 1 2 0 0 
1 1 0 0 1 1 1 1 1 
1 1 1 1 1 0 1 0 0 
1 0 0 1 1 0 1 1 1 
1 1 1 1 0 1 1 0 1 
1 1 0 1 1 1 1 1 1 

Complexity: 4
Time: 306 seconds or 5.1 minutes or 0.09 hours