11 8
49
49 50 58 66 67 59 60 61 53 54 62 70 71 79 87 86 85 77 76 84 83 82 81 73 72 64 56 48 40 32 33 34 26 18 17 16 8 0 1 9 10 11 19 20 12 4 5 13 14 6 7 15 23 31 39 47 46 38 30 29 28 36 44 43 
1 1 0 0 1 1 1 1 
1 1 1 1 1 1 1 1 
1 1 1 1 1 0 0 1 
0 0 1 0 1 1 1 1 
1 1 1 0 1 0 1 1 
1 0 0 1 1 0 1 1 
1 2 1 0 0 1 1 0 
1 0 1 1 1 1 1 0 
1 0 1 1 0 0 1 1 
1 1 0 0 1 1 0 1 
0 1 1 1 1 1 1 1 

Complexity: 4
Time: 118 seconds or 1.97 minutes or 0.03 hours