9 9
49
49 50 41 40 31 22 21 20 29 38 37 36 27 18 9 10 1 2 3 4 13 14 5 6 7 16 17 26 25 24 33 34 35 44 53 52 51 60 59 58 57 48 47 46 45 54 63 64 65 74 75 76 67 68 77 78 69 70 71 
0 1 1 1 1 1 1 1 0 
1 1 0 0 1 1 0 1 1 
1 0 1 1 1 0 1 1 1 
1 0 1 0 1 0 1 1 1 
1 1 1 0 1 1 0 0 1 
1 1 1 1 2 1 1 1 1 
1 0 0 1 1 1 1 0 0 
1 1 1 0 1 1 1 1 1 
0 0 1 1 1 1 1 0 0 

Complexity: 4
Time: 136 seconds or 2.27 minutes or 0.04 hours