11 8
31
31 39 47 46 45 53 61 62 63 71 79 78 77 85 84 83 82 74 73 72 64 56 48 40 32 33 41 49 50 58 66 67 68 60 52 44 43 35 36 37 29 28 20 19 18 26 25 17 9 8 0 1 2 3 4 12 13 14 22 23 15 7 
1 1 1 1 1 0 0 1 
1 1 0 0 1 1 1 1 
0 1 1 1 1 0 1 1 
0 1 1 0 1 1 0 2 
1 1 0 1 1 1 0 1 
1 1 0 1 1 1 1 1 
1 1 1 0 1 1 0 0 
1 0 1 0 1 1 1 1 
1 0 1 1 1 0 0 1 
1 1 1 0 0 1 1 1 
0 0 1 1 1 1 0 0 

Complexity: 4
Time: 1877 seconds or 31.29 minutes or 0.52 hours