10 9
73
73 74 83 84 75 66 57 56 55 46 37 38 39 30 21 22 23 24 33 42 51 50 41 40 49 58 67 68 69 78 77 86 87 88 79 80 71 62 61 52 53 44 35 26 25 16 7 6 5 4 13 12 11 10 1 0 9 18 19 28 27 36 45 54 63 72 81 
1 1 0 0 1 1 1 1 0 
1 1 1 1 1 0 0 1 0 
1 1 0 1 1 1 1 1 1 
1 1 0 1 0 0 1 0 1 
1 1 1 1 1 1 1 0 1 
1 1 0 0 1 1 1 1 1 
1 1 1 1 1 0 0 1 1 
1 0 0 1 1 1 1 0 1 
1 2 1 1 0 1 1 1 1 
1 0 1 1 0 1 1 1 0 

Complexity: 4
Time: 703 seconds or 11.71 minutes or 0.2 hours