11 8
60
60 52 53 54 62 63 55 47 39 38 37 29 21 22 23 15 7 6 5 4 12 11 3 2 1 9 8 16 17 18 26 27 28 36 44 43 42 41 33 32 40 48 49 57 58 59 67 68 69 77 78 79 87 86 85 84 83 82 74 73 65 64 72 80 
0 1 1 1 1 1 1 1 
1 1 0 1 1 0 0 1 
1 1 1 0 0 1 1 1 
0 0 1 1 1 1 0 0 
1 1 0 0 1 1 1 1 
1 1 1 1 1 0 0 1 
1 1 0 0 1 1 1 1 
0 1 1 1 2 0 1 1 
1 1 0 1 1 1 0 0 
1 1 1 0 0 1 1 1 
1 0 1 1 1 1 1 1 

Complexity: 4
Time: 874 seconds or 14.57 minutes or 0.24 hours