9 9
73
73 64 65 56 57 66 75 76 77 78 69 68 59 58 49 48 47 46 55 54 45 36 37 28 27 18 9 0 1 10 19 20 21 30 39 40 41 32 33 24 23 14 13 12 3 4 5 6 7 16 17 26 35 44 43 42 51 52 61 62 71 80 
1 1 0 1 1 1 1 1 0 
1 1 0 1 1 1 0 1 1 
1 1 1 1 0 1 1 0 1 
1 1 0 1 0 1 1 0 1 
1 1 0 1 1 1 1 1 1 
1 1 1 1 1 0 1 1 0 
1 1 1 1 1 1 0 1 1 
0 1 1 1 0 1 1 0 1 
0 2 0 1 1 1 1 0 1 

Complexity: 4
Time: 423 seconds or 7.04 minutes or 0.12 hours