10 8
4
4 5 6 14 15 23 31 39 38 30 29 21 13 12 11 3 2 1 9 8 16 17 18 26 27 28 36 35 43 42 50 58 59 60 52 53 45 46 54 55 63 71 70 69 77 76 68 67 75 74 73 65 64 56 48 49 41 33 32 
0 1 1 1 2 1 1 0 
1 1 0 1 1 1 1 1 
1 1 1 0 0 1 0 1 
0 0 1 1 1 1 1 1 
1 1 0 1 1 0 1 1 
0 1 1 1 0 1 1 0 
1 1 1 0 1 1 1 1 
1 0 1 1 1 0 0 1 
1 1 0 1 1 1 1 1 
0 1 1 1 1 1 0 0 

Complexity: 4
Time: 461 seconds or 7.69 minutes or 0.13 hours