11 8
47
47 46 45 53 61 62 63 71 70 78 86 85 84 76 68 67 75 83 82 81 80 72 64 65 66 58 59 51 52 44 36 37 29 30 31 23 15 7 6 5 13 21 20 28 27 26 34 42 41 49 48 40 32 24 25 17 9 10 11 3 2 1 0 
1 1 1 1 0 1 1 1 
0 1 1 1 0 1 0 1 
0 1 0 0 1 1 0 1 
1 1 1 1 1 1 1 1 
1 0 1 0 1 1 0 0 
1 1 1 0 1 1 1 2 
1 1 0 1 1 1 0 0 
0 0 1 1 0 1 1 1 
1 1 1 1 1 0 1 1 
1 0 0 1 1 0 1 0 
1 1 1 1 1 1 1 0 

Complexity: 4
Time: 546 seconds or 9.1 minutes or 0.15 hours