10 8
62
62 63 55 54 46 38 39 31 23 15 14 6 5 4 3 11 12 13 21 29 37 36 28 27 26 18 17 9 1 0 8 16 24 25 33 41 42 43 44 52 51 59 60 61 69 70 78 77 76 75 74 66 65 57 49 48 56 64 72 
1 1 0 1 1 1 1 0 
1 1 0 1 1 1 1 1 
1 1 1 0 0 1 0 1 
1 1 1 1 1 1 0 1 
0 1 0 0 1 1 1 1 
0 1 1 1 1 0 1 0 
1 1 0 1 1 0 1 1 
1 1 0 1 1 1 2 1 
1 1 1 0 0 1 1 0 
1 0 1 1 1 1 1 0 

Complexity: 4
Time: 253 seconds or 4.21 minutes or 0.07 hours