11 8
42
42 43 51 52 44 36 37 38 30 31 23 15 7 6 14 13 21 20 12 4 3 2 1 9 8 16 17 18 19 27 26 25 33 41 40 48 49 50 58 66 67 68 69 61 62 54 46 47 55 63 71 79 78 77 85 84 83 75 74 73 65 64 72 80 
0 1 1 1 1 0 1 1 
1 1 0 0 1 1 1 1 
1 1 1 1 1 1 0 1 
0 1 1 1 0 0 1 1 
0 1 0 0 1 1 1 0 
1 1 2 1 1 0 1 1 
1 1 1 1 1 0 1 1 
0 0 1 0 0 1 1 1 
1 1 1 1 1 1 0 1 
1 1 1 1 0 1 1 1 
1 0 0 1 1 1 0 0 

Complexity: 4
Time: 2283 seconds or 38.05 minutes or 0.63 hours