11 8
16
16 8 0 1 2 10 18 19 20 12 4 5 13 14 15 23 31 30 29 37 38 46 47 55 63 71 70 78 86 85 77 76 75 67 68 60 61 53 52 44 43 35 27 26 25 24 32 33 41 49 50 58 57 56 64 72 73 74 82 
1 1 1 0 1 1 0 0 
1 0 1 0 1 1 1 1 
2 0 1 1 1 0 0 1 
1 1 1 1 0 1 1 1 
1 1 0 1 0 1 1 0 
0 1 0 1 1 0 1 1 
0 1 1 0 1 1 0 1 
1 1 1 0 1 1 0 1 
1 0 0 1 1 0 1 1 
1 1 1 1 1 1 1 0 
0 0 1 0 0 1 1 0 

Complexity: 4
Time: 327 seconds or 5.45 minutes or 0.09 hours