9 9
12
12 3 4 13 14 15 6 7 8 17 16 25 34 35 44 53 62 61 70 79 78 69 68 77 76 67 58 49 50 51 42 33 32 31 22 21 20 11 2 1 0 9 18 19 28 37 36 45 54 55 64 63 72 73 74 75 66 65 56 47 38 39 
1 1 1 1 1 0 1 1 1 
1 0 1 2 1 1 1 1 1 
1 1 1 1 1 0 0 1 0 
0 1 0 0 1 1 1 1 1 
1 1 1 1 0 0 1 0 1 
1 0 1 0 1 1 1 0 1 
1 1 1 0 1 0 0 1 1 
1 1 1 1 1 1 1 1 0 
1 1 1 1 1 1 1 1 0 

Complexity: 4
Time: 340 seconds or 5.66 minutes or 0.09 hours