10 8
31
31 23 15 7 6 5 13 21 20 28 29 30 38 39 47 55 54 62 70 71 79 78 77 76 68 60 52 53 45 44 43 35 27 26 18 10 11 3 2 1 9 8 16 24 32 33 41 40 48 49 50 58 66 67 75 74 73 65 64 
0 1 1 1 0 1 1 1 
1 1 1 1 0 1 0 1 
1 0 1 0 1 1 0 1 
1 0 1 1 1 1 1 2 
1 1 0 1 0 0 1 1 
1 1 0 1 1 1 0 1 
1 1 1 0 1 1 1 1 
0 0 1 0 1 0 1 0 
1 1 1 1 1 0 1 1 
0 1 1 1 1 1 1 1 

Complexity: 4
Time: 13 seconds or 0.21 minutes or 0 hours