11 8
66
66 58 59 51 52 53 45 37 36 35 27 26 18 10 9 8 0 1 2 3 4 12 20 21 13 14 6 7 15 23 31 30 38 39 47 55 54 62 70 71 79 87 86 85 77 69 68 76 75 74 82 81 73 72 64 56 48 49 41 42 34 33 25 24 
1 1 1 1 1 0 1 1 
1 1 1 0 1 1 1 1 
0 0 1 0 1 1 0 1 
1 1 1 1 0 0 1 1 
0 1 1 1 1 1 1 1 
0 1 1 0 0 1 0 1 
1 1 0 1 1 1 1 1 
1 0 1 1 0 0 1 0 
1 0 2 0 1 1 1 1 
1 1 1 1 1 1 0 1 
0 1 1 0 0 1 1 1 

Complexity: 4
Time: 1168 seconds or 19.47 minutes or 0.32 hours