11 8
24
24 32 33 34 42 50 49 48 56 64 65 66 67 59 51 52 53 45 37 36 35 27 26 18 17 9 8 0 1 2 10 11 12 20 21 13 5 6 14 15 23 22 30 38 46 47 55 54 62 61 69 70 78 79 87 86 85 84 76 75 74 73 81 80 
1 1 1 0 0 1 1 0 
1 1 1 1 1 1 1 1 
0 1 1 0 1 1 1 1 
2 0 1 1 0 0 1 0 
1 1 1 1 1 1 1 0 
0 0 1 0 0 1 1 1 
1 1 1 1 1 1 1 1 
1 0 0 1 0 1 1 0 
1 1 1 1 0 1 1 0 
0 1 1 1 1 0 1 1 
1 1 0 0 1 1 1 1 

Complexity: 4
Time: 373 seconds or 6.21 minutes or 0.1 hours