10 8
68
68 60 61 69 70 71 79 78 77 76 75 67 66 65 57 49 50 51 43 35 36 28 20 21 22 30 38 46 45 53 54 55 47 39 31 23 15 7 6 5 4 12 11 10 9 1 0 8 16 17 18 26 34 33 25 24 32 40 48 56 64 72 
1 1 0 0 1 1 1 1 
1 1 1 1 1 0 0 1 
1 1 1 0 1 1 1 1 
1 1 1 0 1 0 1 1 
1 1 1 1 1 0 1 1 
1 0 0 1 0 1 1 1 
1 1 1 1 0 1 1 1 
1 1 0 0 1 1 0 0 
1 1 1 1 2 1 1 1 
1 0 0 1 1 1 1 1 

Complexity: 4
Time: 17 seconds or 0.28 minutes or 0 hours