10 8
27
27 28 29 21 22 23 15 7 6 5 4 12 20 19 18 10 2 1 0 8 16 17 25 33 34 35 43 51 52 44 45 46 38 39 47 55 63 62 61 69 68 67 66 58 57 49 41 40 48 56 64 72 73 74 75 76 77 78 79 
1 1 1 0 1 1 1 1 
1 0 1 0 1 0 0 1 
1 1 1 1 1 1 1 1 
0 1 0 2 1 1 0 0 
0 1 1 1 0 0 1 1 
1 1 0 1 1 1 1 1 
1 1 0 1 1 0 0 1 
1 1 1 0 0 1 1 1 
1 0 1 1 1 1 0 0 
1 1 1 1 1 1 1 1 

Complexity: 4
Time: 329 seconds or 5.49 minutes or 0.09 hours