10 8
62
62 63 71 79 78 77 69 61 60 52 53 45 46 47 39 38 37 29 30 22 23 15 7 6 14 13 12 20 28 27 26 34 35 43 51 50 58 59 67 75 74 73 65 64 56 48 40 41 33 32 24 16 17 9 10 11 3 2 1 0 
1 1 1 1 0 0 1 1 
0 1 1 1 1 1 1 1 
1 1 0 0 1 0 1 1 
1 0 1 1 1 1 1 0 
1 1 1 1 0 1 1 1 
1 1 0 1 0 1 1 1 
1 0 1 1 1 1 0 0 
1 0 1 1 1 1 2 1 
1 1 0 1 0 1 0 1 
0 1 1 1 0 1 1 1 

Complexity: 4
Time: 751 seconds or 12.52 minutes or 0.21 hours