9 9
33
33 32 41 50 49 48 57 56 55 46 45 36 27 18 9 0 1 2 11 10 19 28 37 38 39 30 21 22 13 4 5 14 15 6 7 8 17 26 25 34 35 44 43 52 53 62 71 70 61 60 69 78 77 68 67 76 75 74 73 64 63 
1 1 1 0 1 1 1 1 1 
1 1 1 0 1 1 1 0 1 
1 1 0 1 1 0 0 1 1 
1 1 0 1 0 1 2 1 1 
1 1 1 1 0 1 0 1 1 
1 1 0 1 1 1 0 1 1 
0 1 1 1 0 0 1 1 1 
1 1 0 0 1 1 1 1 1 
0 1 1 1 1 1 1 0 0 

Complexity: 4
Time: 433 seconds or 7.21 minutes or 0.12 hours