10 9
38
38 37 46 45 36 27 28 19 18 9 0 1 10 11 2 3 4 13 14 15 6 7 8 17 16 25 34 33 32 31 22 21 30 39 40 49 50 59 68 69 60 51 52 43 44 53 62 71 80 79 88 87 86 85 76 75 66 57 56 65 64 63 72 73 82 83 
1 1 1 1 1 0 1 1 1 
1 1 1 0 1 1 1 1 1 
1 1 0 1 1 0 0 1 0 
1 1 0 1 1 1 1 1 0 
1 1 2 1 1 0 0 1 1 
1 1 0 0 1 1 1 1 1 
0 0 1 1 0 1 1 0 1 
1 1 1 1 0 1 1 0 1 
1 1 0 1 1 0 0 1 1 
0 1 1 0 1 1 1 1 0 

Complexity: 4
Time: 190 seconds or 3.17 minutes or 0.05 hours