9 9
72
72 73 74 75 66 67 76 77 78 79 70 69 60 59 50 41 42 33 32 31 40 39 48 57 56 65 64 63 54 45 46 37 38 29 28 19 18 9 0 1 10 11 12 21 22 13 4 5 14 15 6 7 8 17 26 25 34 35 44 43 52 53 62 
1 1 0 0 1 1 1 1 1 
1 1 1 1 1 1 1 0 1 
1 1 0 1 1 0 0 1 1 
0 1 1 0 1 1 1 1 1 
0 1 1 1 1 1 1 1 1 
1 1 0 1 0 1 0 1 1 
1 0 1 1 0 1 1 0 1 
1 1 1 1 1 0 1 1 0 
2 1 1 1 1 1 1 1 0 

Complexity: 4
Time: 106 seconds or 1.77 minutes or 0.03 hours