10 9
48
48 49 58 67 68 69 60 51 52 43 34 35 26 17 8 7 6 5 4 13 14 15 24 33 42 41 32 31 30 29 20 21 12 11 10 1 0 9 18 27 36 45 46 37 38 47 56 65 64 63 72 81 82 73 74 75 76 85 86 87 78 79 80 71 62 
1 1 0 0 1 1 1 1 1 
1 1 1 1 1 1 1 0 1 
1 0 1 1 0 0 1 0 1 
1 0 1 1 1 1 1 1 1 
1 1 1 0 0 1 1 1 0 
1 1 1 2 1 0 1 1 0 
0 0 1 0 1 0 1 0 1 
1 1 1 0 1 1 1 0 1 
1 1 1 1 1 0 1 1 1 
1 1 0 0 1 1 1 0 0 

Complexity: 4
Time: 1557 seconds or 25.95 minutes or 0.43 hours