9 9
55
55 56 47 38 37 28 27 36 45 54 63 72 73 74 75 66 67 76 77 78 69 70 71 62 53 44 35 26 25 34 43 42 51 60 59 58 49 40 39 30 31 32 23 14 15 16 7 6 5 4 13 12 11 20 19 10 1 0 
1 1 0 0 1 1 1 1 0 
0 1 1 1 1 1 1 1 0 
0 1 1 0 0 1 0 1 1 
1 1 0 1 1 1 0 1 1 
1 1 1 1 1 0 1 1 1 
1 0 1 0 1 0 1 0 1 
1 2 1 0 1 1 1 0 1 
1 0 0 1 1 0 1 1 1 
1 1 1 1 1 1 1 0 0 

Complexity: 4
Time: 95 seconds or 1.58 minutes or 0.03 hours