10 8
53
53 45 46 54 55 47 39 31 30 29 21 22 14 15 7 6 5 4 12 11 19 27 28 36 35 34 33 25 17 9 10 2 1 0 8 16 24 32 40 48 56 57 49 50 42 43 51 59 67 66 65 73 74 75 76 68 60 61 62 70 78 79 
1 1 1 0 1 1 1 1 
1 1 1 1 1 0 1 1 
1 1 0 1 0 1 1 0 
1 1 0 1 1 1 1 1 
1 1 1 1 1 0 0 1 
1 0 1 1 0 1 1 1 
1 1 1 1 0 2 1 1 
1 1 0 1 1 1 1 0 
0 1 1 1 1 0 1 0 
0 1 1 1 1 0 1 1 

Complexity: 4
Time: 323 seconds or 5.38 minutes or 0.09 hours