9 9
70
70 71 62 61 52 53 44 35 34 25 16 17 8 7 6 15 14 5 4 3 2 11 12 13 22 23 32 41 42 51 60 69 78 77 68 67 66 75 74 73 72 63 64 55 56 57 58 49 40 39 30 29 38 37 46 45 36 27 28 19 18 9 0 
1 0 1 1 1 1 1 1 1 
1 0 1 1 1 1 1 1 1 
1 1 0 0 1 1 0 1 0 
1 1 1 1 0 1 0 1 1 
1 1 1 1 1 1 1 0 1 
1 1 0 0 1 0 1 1 1 
0 1 1 1 1 0 1 1 1 
1 1 0 1 1 1 1 2 1 
1 1 1 1 0 1 1 0 0 

Complexity: 4
Time: 44 seconds or 0.73 minutes or 0.01 hours