11 8
18
18 17 9 1 0 8 16 24 32 40 48 49 41 33 34 42 43 35 36 37 29 28 27 19 11 3 4 12 13 5 6 7 15 14 22 23 31 39 47 46 54 62 63 71 79 87 86 85 84 83 75 76 77 69 61 53 52 60 59 58 66 74 73 65 64 72 80 
1 1 0 1 1 1 1 1 
1 1 0 1 1 1 1 1 
1 1 2 1 0 0 1 1 
1 0 0 1 1 1 0 1 
1 1 1 1 1 1 0 1 
1 1 1 1 0 0 1 1 
1 1 0 0 1 1 1 0 
0 0 1 1 1 1 1 1 
1 1 1 0 0 1 0 1 
1 1 1 1 1 1 0 1 
1 0 0 1 1 1 1 1 

Complexity: 4
Time: 90 seconds or 1.5 minutes or 0.03 hours