9 9
32
32 41 40 31 30 39 38 47 56 55 46 45 54 63 72 73 74 75 76 67 66 57 58 59 50 51 60 69 78 79 80 71 62 53 52 43 34 25 26 17 8 7 6 15 24 23 22 13 4 3 2 11 20 19 28 27 18 9 0 
1 0 1 1 1 0 1 1 1 
1 0 1 0 1 0 1 0 1 
1 1 1 0 1 1 1 1 1 
1 1 0 1 1 2 0 1 0 
0 0 1 1 1 1 0 1 0 
1 1 1 0 0 1 1 1 1 
1 1 1 1 1 1 1 0 1 
1 0 0 1 1 0 1 0 1 
1 1 1 1 1 0 1 1 1 

Complexity: 4
Time: 622 seconds or 10.37 minutes or 0.17 hours