10 9
14
14 13 4 5 6 7 8 17 16 15 24 33 34 35 44 53 62 61 70 79 80 89 88 87 78 77 76 67 66 75 84 83 82 73 64 63 54 55 56 47 48 57 58 59 60 51 42 41 40 31 22 21 30 29 28 37 36 27 18 19 20 11 2 1 0 
1 1 1 0 1 1 1 1 1 
0 0 1 0 1 2 1 1 1 
1 1 1 1 1 0 1 0 0 
1 1 1 1 1 0 1 1 1 
1 1 0 0 1 1 1 0 1 
0 0 1 1 0 0 1 0 1 
1 1 1 1 1 1 1 1 1 
1 1 0 1 1 0 0 1 0 
0 1 0 1 1 1 1 1 1 
0 1 1 1 0 0 1 1 1 

Complexity: 4
Time: 563 seconds or 9.39 minutes or 0.16 hours