10 9
7
7 8 17 16 25 24 33 34 43 44 53 62 71 70 79 88 87 86 77 68 67 58 59 60 51 50 41 40 49 48 47 56 65 74 75 84 83 82 73 64 63 54 45 36 37 28 27 18 9 0 1 2 11 20 29 30 21 12 13 22 23 14 5 
1 1 1 0 0 1 0 2 1 
1 0 1 1 1 1 0 1 1 
1 0 1 1 1 1 1 1 0 
1 1 1 1 0 0 1 1 0 
1 1 0 0 1 1 0 1 1 
1 0 1 1 1 1 1 0 1 
1 0 1 0 1 1 1 0 1 
1 1 1 0 1 1 0 1 1 
0 1 1 1 0 1 0 1 0 
0 1 1 1 0 1 1 1 0 

Complexity: 4
Time: 139 seconds or 2.32 minutes or 0.04 hours