10 9
43
43 44 53 62 61 70 71 80 79 78 87 86 77 68 59 50 51 42 41 32 33 34 25 16 17 8 7 6 5 14 23 22 21 12 3 2 11 10 9 18 19 20 29 30 39 48 49 58 67 76 75 84 83 82 81 72 63 64 65 56 55 46 37 36 
0 0 1 1 0 1 1 1 1 
1 1 1 1 0 1 0 1 1 
1 1 1 1 1 1 0 1 0 
0 0 1 1 0 1 1 1 0 
1 1 0 1 0 1 1 2 1 
0 1 0 1 1 1 1 0 1 
0 1 1 0 1 1 0 1 1 
1 1 1 0 1 1 0 1 1 
1 0 0 1 1 1 1 1 1 
1 1 1 1 0 1 1 0 0 

Complexity: 4
Time: 211 seconds or 3.51 minutes or 0.06 hours