11 8
20
20 12 13 14 6 7 15 23 22 30 31 39 47 55 54 62 61 69 70 71 79 78 86 85 84 76 75 83 82 74 66 67 59 51 52 44 45 37 36 28 27 26 18 10 11 3 2 1 9 8 16 24 32 33 34 42 41 40 48 49 57 65 64 72 80 
0 1 1 1 0 0 1 1 
1 1 1 1 1 1 1 1 
1 0 1 0 2 0 1 1 
1 0 1 1 1 0 1 1 
1 1 1 0 1 1 0 1 
1 1 1 0 1 1 0 1 
1 1 0 1 1 0 1 1 
0 1 0 1 0 1 1 0 
1 1 1 1 0 1 1 1 
1 0 1 1 1 0 1 1 
1 0 1 1 1 1 1 0 

Complexity: 4
Time: 1369 seconds or 22.82 minutes or 0.38 hours