11 8
25
25 26 27 35 43 44 52 51 50 58 57 65 64 56 48 40 41 33 32 24 16 8 0 1 9 10 11 19 20 12 4 5 13 14 15 23 31 30 29 37 38 39 47 46 54 55 63 62 61 69 70 71 79 87 86 85 84 76 68 67 75 74 73 81 
1 1 0 0 1 1 0 0 
1 1 1 1 1 1 1 1 
1 0 0 1 1 0 0 1 
1 2 1 1 0 1 1 1 
1 1 0 1 0 1 1 1 
1 1 0 1 1 0 1 1 
1 0 1 1 1 0 1 1 
1 1 1 0 0 1 1 1 
1 1 0 1 1 1 1 1 
0 1 1 1 1 0 0 1 
0 1 0 0 1 1 1 1 

Complexity: 4
Time: 2729 seconds or 45.49 minutes or 0.76 hours