9 9
57
57 58 67 68 77 76 75 66 65 64 73 72 63 54 45 36 27 28 37 46 47 38 39 40 31 32 41 50 51 60 61 70 79 80 71 62 53 44 43 34 35 26 17 8 7 16 25 24 23 14 5 4 3 12 21 20 11 10 9 0 
1 0 0 1 1 1 0 1 1 
1 1 1 1 0 1 0 1 1 
0 0 1 1 0 1 1 1 1 
1 1 0 0 1 1 0 1 1 
1 1 1 1 1 1 0 1 1 
1 1 1 0 0 1 1 0 1 
1 0 0 2 1 0 1 1 1 
1 1 1 1 1 1 0 1 1 
1 1 0 1 1 1 0 1 1 

Complexity: 4
Time: 182 seconds or 3.03 minutes or 0.05 hours