11 8
6
6 7 15 14 13 21 29 30 31 39 47 55 54 62 63 71 79 87 86 85 77 69 68 76 75 74 82 81 73 65 64 56 57 58 50 51 59 60 52 44 45 37 36 35 34 33 41 40 32 24 25 26 18 19 20 12 4 3 2 1 9 8 
0 1 1 1 1 0 2 1 
1 1 0 0 1 1 1 1 
0 0 1 1 1 1 0 0 
1 1 1 0 0 1 1 1 
1 1 1 1 1 1 0 1 
1 1 0 0 1 1 0 1 
0 0 1 1 1 0 1 1 
1 1 1 1 1 0 1 1 
1 1 0 0 1 1 0 1 
0 1 1 1 1 1 0 1 
0 1 1 0 0 1 1 1 

Complexity: 4
Time: 1541 seconds or 25.68 minutes or 0.43 hours