10 8
0
0 8 9 10 2 3 11 12 13 5 6 7 15 14 22 23 31 39 47 46 54 62 63 71 79 78 77 69 61 60 52 44 43 42 34 35 36 37 29 21 20 19 18 26 25 24 32 40 48 49 57 58 59 67 75 74 73 65 64 
2 0 1 1 0 1 1 1 
1 1 1 1 1 1 1 1 
0 0 1 1 1 1 1 1 
1 1 1 0 0 1 0 1 
1 0 1 1 1 1 0 1 
1 0 1 1 1 0 1 1 
1 1 0 0 1 0 1 0 
0 1 1 1 1 1 1 1 
1 1 0 1 0 1 0 1 
0 1 1 1 0 1 1 1 

Complexity: 4
Time: 437 seconds or 7.28 minutes or 0.12 hours