11 8
48
48 40 32 33 34 42 50 58 57 65 64 72 73 81 82 74 75 76 77 85 86 87 79 71 63 62 70 69 68 67 59 51 52 53 45 37 36 35 27 26 18 17 16 8 9 10 2 3 4 12 20 21 13 5 6 7 15 23 31 30 38 46 47 
0 0 1 1 1 1 1 1 
1 1 1 0 1 1 0 1 
1 1 1 0 1 1 0 1 
0 0 1 1 0 0 1 1 
1 1 1 1 1 1 1 0 
1 0 1 0 0 1 1 1 
2 0 1 1 1 1 0 0 
0 1 1 1 0 0 1 1 
1 1 0 1 1 1 1 1 
1 1 1 1 1 1 0 1 
0 1 1 0 0 1 1 1 

Complexity: 4
Time: 1581 seconds or 26.35 minutes or 0.44 hours