11 8
32
32 24 16 17 9 8 0 1 2 3 4 12 11 19 27 26 25 33 41 42 43 44 36 28 29 21 22 14 6 7 15 23 31 39 38 46 45 53 52 60 68 67 59 58 57 49 48 56 64 72 73 74 82 83 84 76 77 85 86 87 79 71 70 62 63 55 
1 1 1 1 1 0 1 1 
1 1 0 1 1 0 1 1 
1 1 0 1 0 1 1 1 
1 1 1 1 1 1 0 1 
2 1 0 0 1 0 1 1 
0 1 1 1 1 1 1 0 
1 1 0 0 1 1 0 1 
1 1 1 1 1 0 1 1 
1 0 0 1 1 0 1 1 
1 1 1 0 1 1 0 1 
0 0 1 1 1 1 1 1 

Complexity: 4
Time: 669 seconds or 11.15 minutes or 0.19 hours