11 8
71
71 63 55 47 46 45 37 36 28 20 21 22 30 31 23 15 14 6 5 4 3 11 19 18 26 34 35 43 44 52 60 61 62 70 78 86 85 84 76 68 67 66 74 82 81 73 65 64 56 57 58 50 49 41 33 32 24 16 17 9 1 0 
1 1 0 1 1 1 1 0 
0 1 0 1 0 0 1 1 
1 1 1 1 1 1 1 1 
1 0 1 0 1 0 1 1 
1 1 1 1 1 1 0 0 
0 1 0 1 1 1 1 1 
0 1 1 0 1 0 0 1 
1 1 1 0 1 1 1 1 
1 1 1 1 1 0 1 2 
0 1 1 0 1 0 1 0 
0 1 1 0 1 1 1 0 

Complexity: 4
Time: 1845 seconds or 30.74 minutes or 0.51 hours