11 8
77
77 76 84 83 75 67 66 65 73 81 80 72 64 56 57 49 48 40 32 33 41 42 43 51 59 60 61 53 45 37 36 35 27 26 18 17 16 8 0 1 2 3 11 19 20 21 13 5 6 14 15 23 22 30 38 39 47 55 63 62 70 78 79 87 
1 1 1 1 0 1 1 0 
1 0 0 1 0 1 1 1 
1 1 1 1 1 1 1 1 
0 0 1 1 0 0 1 0 
1 1 0 1 1 1 1 1 
1 1 1 1 0 1 0 1 
1 1 0 1 0 1 0 1 
1 1 0 1 1 1 1 1 
1 1 1 1 0 0 1 0 
1 1 0 1 1 2 1 1 
1 1 0 1 1 0 0 1 

Complexity: 4
Time: 69 seconds or 1.16 minutes or 0.02 hours