9 9
56
56 55 46 37 36 27 18 19 10 1 2 3 4 5 14 15 24 25 16 7 8 17 26 35 44 53 62 71 70 79 78 77 68 59 60 61 52 43 42 41 32 23 22 13 12 21 20 29 38 39 40 49 58 57 66 75 74 73 64 63 
0 1 1 1 1 1 0 1 1 
0 1 0 1 1 1 1 1 1 
1 1 1 1 1 1 1 1 1 
1 0 1 0 0 1 0 0 1 
1 1 1 1 1 1 1 1 1 
0 1 0 0 1 0 0 1 1 
0 1 2 1 1 1 1 1 1 
1 1 0 1 0 1 0 1 1 
0 1 1 1 0 1 1 1 0 

Complexity: 4
Time: 19 seconds or 0.32 minutes or 0.01 hours