10 8
55
55 63 71 79 78 70 69 68 76 75 74 73 65 64 56 48 40 41 33 25 24 16 17 18 26 27 28 36 35 43 51 50 58 59 60 61 53 45 46 47 39 38 30 22 21 13 14 15 7 6 5 4 12 11 10 2 1 0 
1 1 1 0 1 1 1 1 
0 0 1 1 1 1 1 1 
1 1 1 0 0 1 1 0 
1 1 1 1 1 0 1 0 
0 1 0 1 1 0 1 1 
1 1 0 1 0 1 1 1 
1 0 1 1 0 1 0 2 
1 0 1 1 1 1 0 1 
1 1 0 0 1 1 1 1 
0 1 1 1 1 0 1 1 

Complexity: 4
Time: 451 seconds or 7.52 minutes or 0.13 hours