9 9
20
20 11 12 3 2 1 0 9 18 27 36 37 28 29 30 21 22 23 24 15 14 5 6 7 8 17 26 35 34 33 42 41 40 49 48 47 56 55 54 63 64 73 74 75 66 67 76 77 78 69 68 59 60 61 52 53 62 71 80 
1 1 1 1 0 1 1 1 1 
1 0 1 1 0 1 1 0 1 
1 0 2 1 1 1 1 0 1 
1 1 1 1 0 0 1 1 1 
1 1 0 0 1 1 1 0 0 
0 0 1 1 1 0 0 1 1 
1 1 1 0 0 1 1 1 1 
1 1 0 1 1 1 1 0 1 
0 1 1 1 1 1 1 0 1 

Complexity: 4
Time: 260 seconds or 4.33 minutes or 0.07 hours