9 9
10
10 11 2 3 4 13 22 21 20 29 38 47 48 49 58 59 60 51 50 41 40 31 32 23 24 15 6 7 8 17 26 35 34 43 44 53 62 71 70 79 78 77 76 67 66 65 74 73 72 63 64 55 46 37 36 27 18 9 0 
1 0 1 1 1 0 1 1 1 
1 2 1 0 1 0 1 0 1 
1 0 1 1 1 1 1 0 1 
1 0 1 0 1 1 0 1 1 
1 1 1 0 1 1 0 1 1 
0 1 1 1 1 1 1 0 1 
0 1 0 0 1 1 1 0 1 
1 1 1 1 1 0 0 1 1 
1 1 1 0 1 1 1 1 0 

Complexity: 4
Time: 160 seconds or 2.67 minutes or 0.04 hours