9 9
26
26 17 8 7 6 5 4 13 14 15 24 25 34 43 44 53 52 51 60 61 62 71 80 79 78 77 68 67 58 57 48 49 40 41 32 31 30 21 20 11 2 1 0 9 18 27 28 37 38 47 46 45 54 63 72 73 64 65 74 75 
1 1 1 0 1 1 1 1 1 
1 0 1 0 1 1 1 0 1 
1 0 1 1 0 0 1 1 2 
1 1 0 1 1 1 0 1 0 
0 1 1 0 1 1 0 1 1 
1 1 1 1 1 0 1 1 1 
1 0 0 1 1 0 1 1 1 
1 1 1 0 1 1 0 0 1 
1 1 1 1 0 1 1 1 1 

Complexity: 4
Time: 341 seconds or 5.69 minutes or 0.09 hours