9 9
37
37 38 47 48 49 50 41 32 31 30 29 20 19 18 27 36 45 54 55 64 63 72 73 74 75 66 57 58 67 76 77 78 79 80 71 70 69 60 51 52 53 44 43 34 35 26 17 8 7 16 25 24 23 14 5 4 13 12 11 2 1 0 
1 1 1 0 1 1 0 1 1 
0 0 1 1 1 1 0 1 1 
1 1 1 0 0 1 1 1 1 
1 0 1 1 1 1 0 1 1 
1 2 1 0 0 1 0 1 1 
1 0 1 1 1 1 1 1 1 
1 1 0 1 1 0 1 0 0 
1 1 0 1 1 0 1 1 1 
1 1 1 1 1 1 1 1 1 

Complexity: 4
Time: 62 seconds or 1.03 minutes or 0.02 hours