9 9
55
55 64 63 72 73 74 65 66 57 58 67 76 77 78 79 80 71 70 69 60 59 50 41 40 39 30 29 38 47 46 37 36 27 28 19 10 9 0 1 2 3 12 21 22 23 14 5 6 7 8 17 26 25 24 33 34 43 52 53 
1 1 1 1 0 1 1 1 1 
1 1 0 1 0 1 0 0 1 
0 1 0 1 1 1 1 1 1 
1 1 1 1 0 0 1 1 0 
1 1 1 1 1 1 0 1 0 
0 1 1 0 0 1 0 1 1 
0 2 0 1 1 1 1 0 0 
1 1 1 1 1 0 1 1 1 
1 1 1 0 1 1 1 1 1 

Complexity: 4
Time: 58 seconds or 0.97 minutes or 0.02 hours