10 9
28
28 29 30 31 40 41 42 51 50 59 60 69 70 79 88 89 80 71 62 53 44 43 34 35 26 17 16 7 6 15 24 23 14 5 4 3 12 21 20 19 10 1 0 9 18 27 36 37 46 47 48 57 66 67 76 77 86 85 84 83 74 65 64 55 54 63 72 81 
1 1 0 1 1 1 1 1 0 
1 1 0 1 0 1 1 1 1 
1 1 1 1 0 1 1 0 1 
1 2 1 1 1 0 0 1 1 
1 1 0 0 1 1 1 1 1 
0 1 1 1 0 1 1 0 1 
1 1 0 1 0 1 1 0 1 
1 1 1 1 1 0 1 1 1 
1 0 1 0 1 1 0 1 1 
1 0 1 1 1 1 0 1 1 

Complexity: 4
Time: 6651 seconds or 110.84 minutes or 1.85 hours