11 8
79
79 87 86 85 84 76 77 78 70 71 63 55 47 39 31 30 38 46 54 53 61 60 59 67 66 74 82 81 73 65 64 56 48 49 50 42 43 44 36 28 29 21 13 14 15 7 6 5 4 3 11 19 18 26 34 33 32 24 16 17 9 1 0 
1 1 0 1 1 1 1 1 
0 1 0 1 0 1 1 1 
1 1 1 1 0 1 0 0 
1 0 1 0 1 1 1 1 
1 1 1 0 1 0 1 1 
0 0 1 1 1 0 1 1 
1 1 1 0 0 1 1 1 
1 0 0 1 1 1 0 1 
1 1 1 1 0 0 1 1 
0 1 1 0 1 1 1 2 
0 1 1 0 1 1 1 1 

Complexity: 4
Time: 492 seconds or 8.19 minutes or 0.14 hours