9 10
36
36 46 45 44 54 53 43 33 32 31 21 20 10 11 1 2 3 4 14 13 23 24 25 26 16 6 7 17 18 19 29 28 38 48 47 57 58 59 69 79 89 88 87 77 67 66 65 64 74 75 85 84 83 82 81 80 70 71 72 62 61 51 41 40 
0 1 1 1 1 0 1 1 0 0 
1 1 0 1 1 0 1 1 1 1 
1 1 0 1 1 1 1 0 1 1 
0 1 1 1 0 0 2 0 1 0 
1 1 0 1 1 1 1 1 1 0 
0 1 0 1 1 0 0 1 1 1 
0 1 1 0 1 1 1 1 0 1 
1 1 1 0 1 1 0 1 0 1 
1 1 1 1 1 1 0 1 1 1 

Complexity: 4
Time: 2491 seconds or 41.51 minutes or 0.69 hours