10 9
56
56 55 54 63 64 73 82 83 74 65 66 75 76 77 86 87 88 79 80 71 70 69 60 59 58 49 48 47 38 37 36 27 28 19 18 9 10 1 2 11 12 21 30 31 32 41 42 43 52 53 44 35 34 33 24 15 14 13 4 5 6 7 16 17 
0 1 1 0 1 1 1 1 0 
1 1 1 1 1 1 1 1 1 
1 1 0 1 0 0 1 0 0 
1 1 0 1 1 1 1 1 1 
1 1 1 0 0 1 1 1 1 
0 0 1 1 1 0 0 1 1 
1 1 2 0 1 1 1 0 0 
1 1 1 1 0 0 1 1 1 
0 1 1 1 1 1 0 1 1 
0 1 1 0 0 1 1 1 0 

Complexity: 4
Time: 152 seconds or 2.53 minutes or 0.04 hours