9 10
65
65 66 67 57 56 46 36 26 27 17 7 8 9 19 29 39 38 48 49 59 69 79 78 88 87 86 85 75 74 84 83 82 81 71 70 60 50 51 61 62 63 53 54 44 34 35 25 15 5 4 3 13 23 22 32 42 41 31 30 20 10 11 1 
0 1 0 1 1 1 0 1 1 1 
1 1 0 1 0 1 0 1 0 1 
1 0 1 1 0 1 1 1 0 1 
1 1 1 0 1 1 1 0 1 1 
0 1 1 0 1 0 1 0 1 1 
1 1 0 1 1 0 1 1 0 1 
1 1 1 1 0 2 1 1 0 1 
1 1 0 0 1 1 0 0 1 1 
0 1 1 1 1 1 1 1 1 0 

Complexity: 4
Time: 3567 seconds or 59.45 minutes or 0.99 hours