9 8
51
51 52 44 45 46 54 55 63 71 70 69 61 60 68 67 59 58 57 65 64 56 48 40 41 42 34 35 27 26 18 17 25 24 16 8 0 1 2 3 11 12 4 5 6 7 15 14 22 21 20 28 29 30 38 39 
1 1 1 1 1 1 1 1 
1 0 0 1 1 0 1 1 
1 1 1 0 1 1 1 0 
1 1 1 1 1 1 1 0 
0 0 1 1 0 0 1 1 
1 1 1 0 1 1 1 0 
1 0 0 2 1 0 1 1 
1 1 1 1 1 1 0 1 
1 1 0 1 1 1 1 1 

Complexity: 3
Time: 50 seconds or 0.84 minutes or 0.01 hours