9 9
41
41 32 33 42 51 60 59 58 57 48 47 38 37 36 45 46 55 54 63 72 73 64 65 74 75 66 67 76 77 78 69 70 71 62 53 44 43 34 25 26 17 16 15 6 5 14 13 12 3 2 1 0 9 18 19 20 29 30 21 22 31 40 
1 1 1 1 0 1 1 0 0 
1 0 0 1 1 1 1 1 1 
1 1 1 1 1 0 0 1 1 
0 0 1 1 1 1 1 1 0 
1 1 1 0 1 2 1 1 1 
1 1 1 1 0 0 1 0 1 
1 1 0 1 1 1 1 0 1 
1 1 1 1 1 0 1 1 1 
1 1 1 1 1 1 1 0 0 

Complexity: 4
Time: 3385 seconds or 56.42 minutes or 0.94 hours