11 8
68
68 69 61 60 59 58 50 49 41 40 48 56 57 65 64 72 80 81 82 74 75 83 84 85 86 78 79 71 63 55 54 53 45 44 43 35 34 26 25 24 16 17 18 10 11 12 20 28 29 37 38 39 31 23 22 14 6 5 4 3 2 1 0 
1 1 1 1 1 1 1 0 
0 0 1 1 1 0 1 0 
1 1 1 0 1 0 1 1 
1 1 1 0 1 1 0 1 
0 0 1 1 0 1 1 1 
1 1 0 1 1 1 0 0 
1 1 1 0 0 1 1 1 
1 1 1 1 1 1 0 1 
1 1 0 0 2 1 0 1 
1 0 1 1 0 0 1 1 
1 1 1 1 1 1 1 0 

Complexity: 4
Time: 313 seconds or 5.21 minutes or 0.09 hours