10 9
24
24 23 32 41 40 49 48 39 38 29 28 27 18 9 0 1 10 11 12 21 22 13 4 5 6 7 16 17 26 35 34 43 44 53 52 51 50 59 60 61 70 71 80 79 88 87 78 77 76 67 66 75 84 83 82 81 72 73 64 65 56 55 46 45 
1 1 0 0 1 1 1 1 0 
1 1 1 1 1 0 0 1 1 
1 0 0 1 1 1 2 0 1 
1 1 1 0 0 1 0 1 1 
0 0 1 1 1 1 0 1 1 
1 1 0 1 1 1 1 1 1 
0 1 1 0 0 1 1 1 0 
0 1 1 1 1 0 0 1 1 
1 1 0 1 1 1 1 1 1 
1 1 1 1 0 0 1 1 0 

Complexity: 4
Time: 3263 seconds or 54.38 minutes or 0.91 hours