10 8
45
45 53 61 60 52 51 50 42 34 26 27 35 36 37 29 28 20 21 13 14 6 7 15 23 31 39 38 46 47 55 63 62 70 78 77 76 75 67 66 74 73 72 64 56 57 49 41 33 32 24 16 17 9 10 11 12 4 3 2 1 0 
1 1 1 1 1 0 1 1 
0 1 1 1 1 1 1 1 
1 1 0 0 1 1 0 1 
1 0 1 1 1 1 0 1 
1 1 1 1 1 1 1 1 
0 1 1 0 0 2 1 1 
0 1 1 1 1 1 0 1 
1 1 0 0 1 1 1 1 
1 0 1 1 0 0 1 0 
1 1 1 1 1 1 1 0 

Complexity: 4
Time: 284 seconds or 4.73 minutes or 0.08 hours