9 9
18
18 9 10 19 28 27 36 37 38 39 40 31 22 21 20 11 2 3 4 5 6 15 14 23 32 41 42 51 60 59 58 57 48 47 56 55 54 63 72 73 74 75 66 67 76 77 78 79 70 71 62 53 44 43 34 25 26 17 8 
0 0 1 1 1 1 1 0 1 
1 1 1 0 0 1 1 0 1 
2 1 1 1 1 1 0 1 1 
1 1 0 0 1 1 0 1 0 
1 1 1 1 1 1 1 1 1 
0 0 1 1 0 0 1 0 1 
1 1 1 1 1 1 1 0 1 
1 0 0 1 1 0 0 1 1 
1 1 1 1 1 1 1 1 0 

Complexity: 4
Time: 79 seconds or 1.32 minutes or 0.02 hours