11 8
45
45 46 38 30 22 21 20 19 27 28 36 44 52 51 59 67 66 74 82 81 80 72 64 56 57 49 41 42 34 33 32 24 16 8 0 1 9 17 18 10 11 12 4 5 6 14 15 23 31 39 47 55 63 62 61 69 68 76 84 85 86 78 79 
1 1 0 0 1 1 1 0 
1 1 1 1 1 0 1 1 
1 1 1 1 1 1 1 1 
1 0 0 1 1 0 1 1 
1 1 1 0 1 0 1 1 
0 1 1 0 1 2 1 1 
0 1 0 1 1 0 0 1 
1 1 0 1 0 1 1 1 
1 0 1 1 1 1 0 0 
1 0 1 0 1 0 1 1 
1 1 1 0 1 1 1 0 

Complexity: 4
Time: 761 seconds or 12.68 minutes or 0.21 hours