11 8
24
24 32 33 34 42 41 49 57 56 64 72 73 81 82 83 84 76 75 74 66 67 59 51 43 44 52 53 61 69 70 78 86 87 79 71 63 55 47 46 45 37 38 30 31 23 22 14 13 12 20 28 27 19 18 17 16 8 9 1 2 3 4 5 6 7 
0 1 1 1 1 1 1 1 
1 1 0 0 1 1 1 0 
1 1 1 1 1 0 1 1 
2 0 0 1 1 0 1 1 
1 1 1 0 0 1 1 0 
0 1 1 1 1 1 1 1 
0 1 0 1 1 1 0 1 
1 1 0 1 0 1 0 1 
1 0 1 1 0 1 1 1 
1 1 1 1 1 0 1 1 
0 1 1 1 1 0 1 1 

Complexity: 4
Time: 1169 seconds or 19.49 minutes or 0.32 hours