9 9
53
53 44 43 34 35 26 17 8 7 16 15 24 23 32 41 50 51 52 61 62 71 80 79 78 69 68 77 76 67 66 65 64 73 72 63 54 45 46 55 56 57 58 49 40 39 38 29 30 21 12 13 14 5 4 3 2 1 0 9 10 19 28 27 
1 1 1 1 1 1 0 1 1 
1 1 0 1 1 1 1 1 1 
0 1 0 1 0 1 1 0 1 
1 1 1 1 0 1 0 1 1 
0 0 1 1 1 1 0 1 1 
1 1 0 0 1 1 1 1 2 
1 1 1 1 1 0 0 1 1 
1 1 1 1 1 1 1 0 1 
1 1 0 0 1 1 1 1 1 

Complexity: 4
Time: 202 seconds or 3.36 minutes or 0.06 hours