10 8
68
68 76 77 78 79 71 70 62 63 55 47 46 45 44 52 53 61 60 59 51 50 58 66 74 73 72 64 56 48 49 41 40 32 24 16 17 25 26 34 35 27 28 20 21 29 37 38 30 31 23 22 14 15 7 6 5 4 3 11 10 9 8 0 
1 0 0 1 1 1 1 1 
1 1 1 1 0 0 1 1 
1 1 0 0 1 1 1 1 
1 1 1 1 1 1 1 1 
1 0 1 1 0 1 1 0 
1 1 0 0 1 1 1 1 
1 1 1 1 1 1 0 1 
1 0 1 1 1 1 1 1 
1 0 1 0 2 0 1 1 
1 1 1 0 1 1 1 1 

Complexity: 4
Time: 42 seconds or 0.7 minutes or 0.01 hours