8 10
48
48 49 39 29 28 18 19 9 8 7 6 16 15 14 4 3 2 12 11 21 22 23 33 34 24 25 26 27 37 47 46 45 44 54 55 56 57 67 68 69 79 78 77 76 75 74 64 63 73 72 71 70 60 61 62 52 42 41 40 30 20 10 0 
1 0 1 1 1 0 1 1 1 1 
1 1 1 0 1 1 1 0 1 1 
1 1 1 1 1 1 1 1 1 1 
1 0 0 1 1 0 0 1 0 1 
1 1 1 0 1 1 1 1 2 1 
0 0 1 0 1 1 1 1 0 0 
1 1 1 1 1 0 0 1 1 1 
1 1 1 1 1 1 1 1 1 1 

Complexity: 4
Time: 807 seconds or 13.45 minutes or 0.22 hours