9 8
64
64 65 66 58 50 51 43 44 45 37 29 21 20 28 27 26 34 33 41 49 48 40 32 24 16 17 9 8 0 1 2 10 11 12 13 5 6 7 15 23 31 30 38 39 47 55 54 62 61 60 68 69 70 71 
1 1 1 0 0 1 1 1 
1 1 1 1 1 1 0 1 
1 1 0 0 1 1 0 1 
1 0 1 1 1 1 1 1 
1 1 1 0 0 1 1 1 
1 1 0 1 1 1 0 1 
1 1 1 1 0 0 1 1 
0 0 1 0 1 1 1 0 
2 1 1 0 1 1 1 1 

Complexity: 3
Time: 53 seconds or 0.88 minutes or 0.01 hours