9 9
38
38 37 46 47 48 49 40 41 42 33 32 23 14 13 12 21 30 29 28 27 18 19 10 9 0 1 2 3 4 5 6 7 8 17 16 25 34 35 44 53 52 61 62 71 70 79 78 69 60 59 58 67 76 75 74 65 56 55 54 63 72 
1 1 1 1 1 1 1 1 1 
1 1 0 1 1 1 0 1 1 
1 1 0 1 0 1 0 1 0 
1 1 1 1 0 1 1 1 1 
0 1 2 0 1 1 1 0 1 
0 1 1 1 1 0 0 1 1 
1 1 1 0 1 1 1 1 1 
1 0 1 0 1 0 1 1 1 
1 0 1 1 1 0 1 1 0 

Complexity: 4
Time: 302 seconds or 5.03 minutes or 0.08 hours