10 9
10
10 1 2 3 12 13 14 5 6 7 8 17 16 25 24 23 32 31 40 49 48 39 30 29 20 19 18 27 28 37 46 45 54 55 56 65 66 67 68 59 60 51 42 43 34 35 44 53 52 61 70 79 80 89 88 87 86 77 76 75 74 83 82 73 72 
0 1 1 1 0 1 1 1 1 
0 2 0 1 1 1 0 1 1 
1 1 1 0 0 1 1 1 0 
1 1 1 1 1 1 0 1 1 
0 1 0 1 1 0 1 1 1 
1 1 0 1 1 0 1 1 1 
1 1 1 0 0 1 1 1 0 
0 0 1 1 1 1 0 1 0 
1 1 1 1 1 1 0 1 1 
0 1 1 0 0 1 1 1 1 

Complexity: 4
Time: 755 seconds or 12.58 minutes or 0.21 hours