10 8
68
68 60 59 58 50 49 41 40 48 56 57 65 64 72 73 74 75 76 77 78 70 71 63 62 54 53 45 46 47 39 38 30 31 23 22 14 6 5 4 12 13 21 20 19 27 28 36 44 43 35 34 33 32 24 16 17 18 10 2 1 0 
1 1 1 0 1 1 1 0 
0 0 1 0 1 1 1 0 
1 1 1 1 1 1 1 1 
1 0 0 1 1 0 1 1 
1 1 1 1 1 0 1 1 
1 1 0 1 1 1 1 1 
1 1 1 0 0 1 1 0 
1 1 1 1 1 0 1 1 
1 1 0 0 2 0 1 1 
1 1 1 1 1 1 1 0 

Complexity: 4
Time: 1882 seconds or 31.36 minutes or 0.52 hours