8 10
41
41 42 32 22 21 31 30 40 50 51 61 71 72 62 63 64 54 44 43 33 34 35 25 26 27 37 47 46 56 66 65 75 76 77 78 79 69 68 58 48 49 39 29 19 18 17 7 6 5 4 14 13 3 2 1 11 10 
0 1 1 1 1 1 1 1 0 0 
1 1 0 1 1 0 0 1 1 1 
0 1 1 0 0 1 1 1 0 1 
1 1 1 1 1 1 0 1 0 1 
1 2 1 1 1 0 1 1 1 1 
1 1 0 0 1 0 1 0 1 0 
0 1 1 1 1 1 1 0 1 1 
0 1 1 0 0 1 1 1 1 1 

Complexity: 4
Time: 24 seconds or 0.41 minutes or 0.01 hours