10 9
77
77 76 67 58 49 50 51 42 33 32 31 22 13 12 3 4 5 14 15 6 7 16 17 26 25 34 35 44 53 62 61 60 69 70 79 80 89 88 87 86 85 84 83 74 73 72 63 64 65 56 57 48 39 38 37 46 45 36 27 28 29 20 11 10 9 0 
1 0 0 1 1 1 1 1 0 
1 1 1 1 1 1 1 1 1 
0 0 1 0 1 0 0 1 1 
1 1 1 0 1 1 1 1 1 
1 1 1 1 0 0 1 0 1 
1 1 0 1 1 1 1 0 1 
0 0 1 1 1 0 1 1 1 
1 1 1 0 1 0 1 1 0 
1 1 1 0 1 2 0 1 1 
0 0 1 1 1 1 1 1 1 

Complexity: 4
Time: 229 seconds or 3.82 minutes or 0.06 hours