9 10
27
27 37 36 46 45 44 34 33 23 22 21 31 30 20 10 11 1 2 3 4 14 24 25 15 16 17 7 8 18 19 29 39 49 48 58 68 69 79 89 88 87 77 67 66 56 55 65 75 85 84 74 73 63 53 52 42 41 51 61 60 70 71 72 82 
0 1 1 1 1 0 0 1 1 0 
1 1 0 0 1 1 1 1 1 1 
1 1 1 1 1 1 0 2 0 1 
1 1 0 1 1 0 1 1 0 1 
0 1 1 0 1 1 1 0 1 1 
0 1 1 1 0 1 1 0 1 0 
1 1 0 1 0 1 1 1 1 1 
1 1 1 1 1 1 0 1 0 1 
0 0 1 0 1 1 0 1 1 1 

Complexity: 4
Time: 578 seconds or 9.63 minutes or 0.16 hours