8 10
78
78 77 67 66 76 75 65 55 54 53 63 73 72 71 61 51 50 40 41 42 32 31 30 20 10 0 1 11 12 13 23 24 34 44 45 46 47 37 36 26 16 15 14 4 5 6 7 8 9 19 18 28 29 39 49 48 58 68 69 
1 1 0 0 1 1 1 1 1 1 
1 1 1 1 1 1 1 0 1 1 
1 0 0 1 1 0 1 0 1 1 
1 1 1 0 1 0 1 1 0 1 
1 1 1 0 1 1 1 1 1 1 
1 1 0 1 1 1 0 0 1 0 
0 1 0 1 0 1 1 1 1 1 
0 1 1 1 0 1 1 1 2 0 

Complexity: 4
Time: 148 seconds or 2.46 minutes or 0.04 hours