11 8
19
19 18 17 25 24 16 8 9 1 2 3 11 12 13 14 6 7 15 23 22 30 29 28 36 37 38 46 47 55 54 53 52 51 43 35 34 33 41 49 48 56 57 58 66 67 68 69 61 62 70 78 79 87 86 85 84 83 75 74 73 72 80 
0 1 1 1 0 0 1 1 
1 1 0 1 1 1 1 1 
1 1 1 2 0 0 1 1 
1 1 0 0 1 1 1 0 
0 1 1 1 1 1 1 0 
0 1 0 1 0 0 1 1 
1 1 0 1 1 1 1 1 
1 1 1 0 0 1 1 0 
0 0 1 1 1 1 1 0 
1 1 1 1 0 0 1 1 
1 0 0 1 1 1 1 1 

Complexity: 4
Time: 1524 seconds or 25.4 minutes or 0.42 hours