11 8
57
57 58 66 67 59 51 52 53 45 37 36 35 27 19 20 21 13 5 4 3 2 10 18 17 9 8 16 24 32 33 34 42 50 49 48 56 64 72 73 81 82 83 75 76 68 69 77 78 86 87 79 71 70 62 54 55 47 39 38 30 22 14 15 7 
0 0 1 1 1 1 0 1 
1 1 1 0 0 1 1 1 
1 1 1 1 1 1 1 0 
1 0 0 1 0 0 1 0 
1 1 1 1 1 1 1 1 
0 0 1 0 0 1 0 1 
1 1 1 1 1 1 1 1 
1 2 1 1 0 0 1 0 
1 0 1 1 1 1 1 1 
1 1 0 1 1 1 1 1 
0 1 1 1 0 0 1 1 

Complexity: 4
Time: 1652 seconds or 27.54 minutes or 0.46 hours