10 8
43
43 51 50 42 41 33 32 40 48 56 57 65 64 72 73 74 66 67 75 76 77 78 70 62 63 55 47 39 38 30 22 23 15 14 13 5 4 3 2 10 9 1 0 8 16 24 25 26 27 19 20 28 36 37 45 53 61 60 
1 1 1 1 1 1 0 0 
1 1 1 0 0 1 1 1 
1 0 0 1 1 0 1 1 
1 1 1 1 1 0 1 0 
1 1 0 0 1 1 1 1 
1 1 1 2 0 1 0 1 
1 0 1 1 0 1 0 1 
1 1 0 0 1 1 1 1 
1 1 1 1 0 0 1 0 
1 1 1 1 1 1 1 0 

Complexity: 4
Time:  7 seconds or 0.11 minutes or 0 hours