10 9
52
52 43 44 35 26 25 34 33 32 31 40 39 38 47 56 57 58 59 50 51 60 61 70 71 80 79 88 87 86 77 68 67 66 75 84 83 82 81 72 73 64 63 54 45 36 37 28 19 10 9 0 1 2 11 20 21 22 13 4 5 14 15 16 7 
1 1 1 0 1 1 0 1 0 
1 1 1 0 1 1 1 1 0 
0 1 1 1 1 0 0 1 1 
0 1 0 0 1 1 1 1 1 
1 1 1 1 1 0 0 1 1 
1 0 1 0 0 1 1 2 0 
1 0 1 1 1 1 1 1 0 
1 1 0 1 1 1 0 1 1 
1 1 0 1 0 1 0 1 1 
1 1 1 1 0 1 1 1 0 

Complexity: 4
Time: 589 seconds or 9.81 minutes or 0.16 hours