10 9
38
38 37 28 19 18 9 10 11 2 3 4 13 12 21 30 31 40 41 32 23 24 15 6 7 16 17 26 35 34 43 44 53 52 51 60 59 58 57 48 47 46 45 54 63 72 81 82 73 64 65 74 75 84 85 76 77 68 69 70 71 80 89 88 87 
0 0 1 1 1 0 1 1 0 
1 1 1 1 1 0 1 1 1 
1 1 0 1 0 1 1 0 1 
0 1 0 1 1 1 0 1 1 
0 1 2 0 1 1 0 1 1 
1 1 1 1 0 0 1 1 1 
1 0 0 1 1 1 1 0 0 
1 1 1 0 0 1 1 1 1 
1 1 1 1 1 1 0 0 1 
1 1 0 1 1 0 1 1 1 

Complexity: 4
Time: 2719 seconds or 45.31 minutes or 0.76 hours