10 8
61
61 60 68 76 77 78 79 71 63 62 54 55 47 39 38 30 22 23 15 7 6 5 13 12 11 3 2 1 0 8 9 10 18 19 27 28 29 37 45 44 43 51 59 58 66 74 73 72 64 56 48 49 41 42 34 33 25 24 
1 1 1 1 0 1 1 1 
1 1 1 1 1 1 0 1 
0 0 1 1 0 0 1 1 
1 1 0 1 1 1 1 0 
0 1 1 0 0 1 1 1 
0 1 1 1 1 1 0 1 
1 1 0 1 0 0 1 1 
1 0 1 1 1 2 1 1 
1 0 1 0 1 0 0 1 
1 1 1 0 1 1 1 1 

Complexity: 4
Time: 27 seconds or 0.46 minutes or 0.01 hours