9 9
37
37 36 27 28 19 10 9 0 1 2 11 12 21 30 31 40 39 38 47 56 55 54 63 72 73 64 65 66 75 76 77 68 67 58 49 50 41 32 33 24 15 14 13 4 5 6 7 8 17 26 35 34 43 44 53 52 61 60 69 70 79 80 
1 1 1 0 1 1 1 1 1 
1 1 1 1 1 1 1 0 1 
0 1 0 1 0 0 1 0 1 
1 1 0 1 1 1 1 1 1 
1 2 1 1 1 1 0 1 1 
0 0 1 0 1 1 0 1 1 
1 1 1 0 1 0 1 1 0 
1 1 1 1 1 1 1 1 0 
1 1 0 1 1 1 0 1 1 

Complexity: 4
Time: 396 seconds or 6.6 minutes or 0.11 hours