10 9
39
39 30 21 22 31 32 33 42 43 44 35 26 25 16 17 8 7 6 15 14 13 4 3 2 11 10 1 0 9 18 27 28 29 38 37 46 55 54 63 64 73 82 83 74 65 66 57 48 49 50 51 60 61 62 71 80 79 88 87 78 69 68 67 76 85 
1 1 1 1 1 0 1 1 1 
1 1 1 0 1 1 1 1 1 
1 0 0 1 1 0 0 1 1 
1 1 1 1 1 1 1 0 1 
0 1 1 2 0 0 1 1 1 
0 1 0 1 1 1 1 0 0 
1 1 0 1 0 0 1 1 1 
1 1 1 1 1 1 1 0 1 
0 1 1 0 1 0 1 1 1 
0 1 1 0 1 0 1 1 0 

Complexity: 4
Time: 147 seconds or 2.46 minutes or 0.04 hours