10 8
41
41 49 48 40 32 24 16 17 9 1 2 10 11 3 4 5 13 21 20 28 27 26 34 42 43 44 52 51 59 58 57 65 64 72 73 74 75 76 68 69 61 62 70 78 79 71 63 55 54 46 47 39 38 37 29 30 22 14 15 7 
0 1 1 1 1 1 0 1 
0 1 1 1 0 1 1 1 
1 1 0 0 1 1 1 0 
1 0 1 1 1 1 1 0 
1 0 1 0 0 1 1 1 
1 2 1 1 1 0 1 1 
1 1 0 1 1 0 1 1 
0 1 1 1 0 1 1 1 
1 1 0 0 1 1 1 1 
1 1 1 1 1 0 1 1 

Complexity: 4
Time: 294 seconds or 4.91 minutes or 0.08 hours