10 9
85
85 86 77 78 79 88 89 80 71 70 61 62 53 52 51 42 43 34 25 26 17 8 7 16 15 14 13 4 3 2 1 10 9 18 19 28 29 20 21 22 23 32 41 40 39 48 49 50 59 68 67 66 75 74 83 82 73 72 63 64 55 56 47 46 37 36 
0 1 1 1 1 0 0 1 1 
1 1 0 0 1 1 1 1 1 
1 1 1 1 1 1 0 1 1 
0 1 1 0 0 1 0 1 0 
1 1 0 1 1 1 1 1 0 
0 1 1 1 1 1 1 1 1 
0 1 1 0 0 1 0 1 1 
1 1 0 1 1 1 0 1 1 
1 1 1 1 0 1 1 1 1 
0 1 1 0 2 1 0 1 1 

Complexity: 4
Time: 153 seconds or 2.54 minutes or 0.04 hours