9 9
44
44 43 34 35 26 17 8 7 6 15 24 23 14 13 22 31 30 29 38 47 48 49 58 59 50 41 42 51 52 53 62 71 80 79 70 69 68 77 76 75 66 65 74 73 72 63 64 55 46 37 36 27 18 19 20 11 10 1 2 3 
0 1 1 1 0 0 1 1 1 
0 1 1 0 1 1 1 0 1 
1 1 1 0 1 1 1 0 1 
1 0 1 1 1 0 0 1 1 
1 1 1 0 0 1 1 1 2 
0 1 1 1 1 1 1 1 1 
0 1 0 0 1 1 0 0 1 
1 1 1 1 0 1 1 1 1 
1 1 1 1 1 1 0 1 1 

Complexity: 4
Time: 30 seconds or 0.51 minutes or 0.01 hours