11 8
59
59 60 52 51 50 42 34 35 36 28 29 30 22 23 31 39 38 37 45 53 54 55 63 71 79 87 86 78 70 69 77 76 75 83 82 81 80 72 73 65 66 58 57 49 48 40 32 33 25 24 16 8 0 1 2 10 18 19 11 12 13 5 6 7 
1 1 1 0 0 1 1 1 
1 0 1 1 1 1 0 0 
1 0 1 1 0 0 1 1 
1 1 0 0 1 1 1 1 
1 1 1 1 1 1 1 1 
1 0 1 0 0 1 0 0 
1 1 1 1 1 1 1 1 
0 1 1 2 1 0 0 1 
0 1 1 0 0 1 1 1 
1 1 0 1 1 1 1 1 
1 1 1 1 0 0 1 1 

Complexity: 4
Time: 392 seconds or 6.54 minutes or 0.11 hours