8 10
51
51 50 60 61 71 72 73 63 62 52 42 41 31 21 20 10 0 1 11 12 13 3 4 5 6 16 17 18 8 9 19 29 28 38 48 49 59 69 79 78 68 67 57 47 46 36 26 25 24 23 33 34 44 54 55 65 75 76 
1 1 0 1 1 1 1 0 1 1 
1 1 1 1 0 0 1 1 1 1 
1 1 0 1 1 1 1 0 1 1 
0 1 0 1 1 0 1 0 1 0 
0 1 1 0 1 0 1 1 1 1 
1 2 1 0 1 1 0 1 0 1 
1 1 1 1 0 1 0 1 1 1 
0 1 1 1 0 1 1 0 1 1 

Complexity: 4
Time: 49 seconds or 0.81 minutes or 0.01 hours