11 8
73
73 65 66 67 59 60 61 53 52 44 36 35 27 19 18 10 11 12 4 5 6 7 15 23 22 21 29 30 38 46 47 55 63 62 70 71 79 87 86 85 77 76 75 83 82 81 80 72 64 56 48 49 50 42 41 40 32 33 25 17 16 8 9 1 
0 1 0 0 1 1 1 1 
1 1 1 1 1 0 0 1 
1 1 1 1 0 1 1 1 
0 1 0 1 0 1 1 0 
1 1 0 1 1 0 1 0 
1 1 1 0 1 0 1 1 
1 1 1 0 1 1 0 1 
1 0 0 1 1 1 1 1 
1 1 1 1 0 0 1 1 
1 2 0 1 1 1 0 1 
1 1 1 1 0 1 1 1 

Complexity: 4
Time: 1607 seconds or 26.78 minutes or 0.45 hours