10 8
22
22 21 29 37 36 35 43 44 52 60 61 69 77 78 70 71 63 55 54 46 47 39 31 23 15 7 6 5 4 3 11 12 20 19 18 26 25 33 41 49 50 58 66 67 75 74 73 72 64 56 48 40 32 24 16 8 9 1 
0 1 0 1 1 1 1 1 
1 1 0 1 1 0 0 1 
1 0 1 1 1 1 2 1 
1 1 1 0 0 1 0 1 
1 1 0 1 1 1 0 1 
1 1 0 1 1 0 1 1 
1 1 1 0 1 0 1 1 
1 0 1 0 1 1 0 1 
1 0 1 1 0 1 1 1 
1 1 1 1 0 1 1 0 

Complexity: 4
Time: 235 seconds or 3.92 minutes or 0.07 hours