9 9
15
15 24 23 32 41 40 31 30 29 38 39 48 57 58 59 68 77 76 75 74 65 64 63 54 55 46 45 36 27 18 9 0 1 10 19 20 11 12 13 4 5 6 7 8 17 26 25 34 43 44 53 52 51 60 61 70 79 80 
1 1 0 0 1 1 1 1 1 
1 1 1 1 1 0 2 0 1 
1 1 1 0 0 1 1 1 1 
1 0 1 1 1 1 0 1 0 
1 0 1 1 1 1 0 1 1 
1 1 0 1 0 0 1 1 1 
1 1 0 1 1 1 1 1 0 
1 1 1 0 0 1 0 1 0 
0 0 1 1 1 1 0 1 1 

Complexity: 4
Time: 34 seconds or 0.57 minutes or 0.01 hours