10 9
50
50 49 40 39 38 29 28 27 18 9 0 1 2 11 20 21 22 13 4 5 6 7 16 17 26 25 24 23 32 33 42 43 44 53 52 51 60 61 70 79 80 89 88 87 86 77 68 67 66 57 56 55 46 45 54 63 72 81 82 73 74 75 84 
1 1 1 0 1 1 1 1 0 
1 0 1 0 1 0 0 1 1 
1 0 1 1 1 1 1 1 1 
1 1 1 0 0 1 1 0 0 
0 0 1 1 1 0 1 1 1 
1 1 0 0 1 2 1 1 1 
1 1 1 1 0 0 1 1 0 
1 0 0 1 1 1 0 1 0 
1 1 1 1 0 1 0 1 1 
1 1 0 1 0 1 1 1 1 

Complexity: 4
Time: 2738 seconds or 45.63 minutes or 0.76 hours