9 10
58
58 68 69 79 78 88 87 77 67 66 76 75 65 55 54 64 74 84 83 73 72 62 52 42 43 33 34 35 36 46 47 48 38 39 29 19 9 8 18 17 27 26 16 15 5 4 14 13 23 22 12 11 1 0 10 20 30 31 41 51 50 60 61 71 81 
1 1 0 0 1 1 0 0 1 1 
1 1 1 1 1 1 1 1 1 1 
1 0 1 1 0 0 1 1 0 1 
1 1 0 1 1 1 1 0 1 1 
0 1 1 1 0 0 1 1 1 0 
1 1 1 0 1 1 0 0 2 0 
1 1 1 0 1 1 1 1 1 1 
0 1 1 1 1 1 1 1 1 1 
0 1 0 1 1 0 0 1 1 0 

Complexity: 4
Time: 950 seconds or 15.83 minutes or 0.26 hours