9 9
24
24 23 32 41 40 31 30 39 48 57 58 59 60 51 42 43 34 35 44 53 62 61 70 79 78 77 76 67 66 65 64 73 72 63 54 55 46 45 36 37 38 29 20 19 18 9 0 1 2 3 12 13 4 5 6 15 16 17 8 
1 1 1 1 1 1 1 0 1 
1 0 0 1 1 0 1 1 1 
1 1 1 0 0 1 2 0 0 
0 0 1 1 1 1 0 1 1 
1 1 1 1 1 1 1 1 1 
1 1 0 1 0 0 1 0 1 
1 1 0 1 1 1 1 1 1 
1 1 1 1 1 0 0 1 0 
1 1 0 0 1 1 1 1 0 

Complexity: 4
Time: 430 seconds or 7.16 minutes or 0.12 hours