8 10
60
60 70 71 72 62 61 51 41 40 30 20 21 11 10 0 1 2 12 13 3 4 5 15 14 24 34 33 32 42 43 53 63 64 65 75 76 77 78 68 67 57 56 55 45 46 36 26 27 17 7 8 18 19 29 39 38 48 49 59 
1 1 1 1 1 1 0 1 1 0 
1 1 1 1 1 1 0 1 1 1 
1 1 0 0 1 0 1 1 0 1 
1 0 1 1 1 0 1 0 1 1 
1 1 1 1 0 1 1 0 1 1 
0 1 0 1 0 1 1 1 0 1 
2 1 1 1 1 1 0 1 1 0 
1 1 1 0 0 1 1 1 1 0 

Complexity: 4
Time: 294 seconds or 4.9 minutes or 0.08 hours