9 10
23
23 22 21 31 41 40 30 20 10 11 1 2 3 4 5 15 14 24 34 33 43 44 45 46 36 26 16 17 7 8 9 19 29 28 38 39 49 48 47 57 67 66 65 64 54 53 52 51 61 60 70 71 81 82 72 73 74 84 85 86 76 77 78 68 69 79 89 
0 1 1 1 1 1 0 1 1 1 
1 1 0 0 1 1 1 1 0 1 
1 1 1 2 1 0 1 0 1 1 
1 1 0 1 1 0 1 0 1 1 
1 1 0 1 1 1 1 1 1 1 
0 1 1 1 1 0 0 1 0 0 
1 1 0 0 1 1 1 1 1 1 
1 1 1 1 1 0 1 1 1 1 
0 1 1 0 1 1 1 0 0 1 

Complexity: 4
Time: 2956 seconds or 49.26 minutes or 0.82 hours