10 8
33
33 32 24 16 17 9 1 2 3 11 19 20 12 4 5 6 14 15 23 22 30 29 37 38 39 47 46 54 55 63 71 79 78 70 62 61 60 52 44 43 35 27 26 34 42 50 49 48 56 57 58 66 67 68 76 75 74 73 72 
0 1 1 1 1 1 1 0 
0 1 0 1 1 0 1 1 
1 1 0 1 1 0 1 1 
1 0 1 1 0 1 1 0 
1 2 1 1 0 1 1 1 
0 0 1 1 1 0 1 1 
1 1 1 0 1 0 1 1 
1 1 1 0 1 1 1 1 
0 0 1 1 1 0 1 1 
1 1 1 1 1 0 1 1 

Complexity: 4
Time: 136 seconds or 2.26 minutes or 0.04 hours