9 10
41
41 42 52 62 63 64 74 75 85 84 83 82 81 71 61 60 50 40 30 20 21 22 12 11 1 2 3 4 5 15 14 24 34 33 43 44 45 55 56 66 67 77 87 88 89 79 69 59 58 48 47 37 36 26 16 6 7 8 9 19 18 28 38 39 
0 1 1 1 1 1 1 1 1 1 
0 1 1 0 1 1 1 0 1 1 
1 1 1 0 1 0 1 0 1 0 
1 0 0 1 1 0 1 1 1 1 
1 2 1 1 1 1 0 1 1 0 
1 0 1 0 0 1 1 0 1 1 
1 1 1 1 1 0 1 1 0 1 
0 1 0 0 1 1 0 1 0 1 
0 1 1 1 1 1 0 1 1 1 

Complexity: 4
Time: 2417 seconds or 40.28 minutes or 0.67 hours