9 8
11
11 19 20 21 29 37 36 35 34 26 25 33 41 49 50 51 43 44 45 53 61 60 68 67 66 65 57 56 48 40 32 24 16 17 9 8 0 1 2 3 4 5 6 14 15 23 31 39 38 46 47 55 63 62 70 
1 1 1 1 1 1 1 0 
1 1 0 2 0 0 1 1 
1 1 0 1 1 1 0 1 
1 1 1 0 0 1 0 1 
1 1 1 1 1 1 1 1 
1 1 0 1 1 1 1 1 
1 1 1 1 0 1 0 1 
1 1 0 0 1 1 1 1 
0 1 1 1 1 0 1 0 

Complexity: 3
Time: 25 seconds or 0.42 minutes or 0.01 hours