8 10
38
38 37 47 46 56 66 65 75 76 77 78 79 69 68 58 59 49 39 29 19 9 8 18 17 16 26 25 15 5 4 3 2 1 0 10 11 12 13 23 24 34 35 45 44 54 53 63 73 72 62 61 60 50 51 41 42 32 22 21 31 30 
1 1 1 1 1 1 0 0 1 1 
1 1 1 1 0 1 1 1 1 1 
0 1 1 1 1 1 1 0 0 1 
1 1 1 0 1 1 0 1 2 1 
0 1 1 0 1 1 1 1 0 1 
1 1 0 1 1 0 1 0 1 1 
1 1 1 1 0 1 1 0 1 1 
0 0 1 1 0 1 1 1 1 1 

Complexity: 4
Time: 735 seconds or 12.25 minutes or 0.2 hours