8 10
31
31 21 22 12 13 14 4 3 2 1 11 10 20 30 40 50 60 70 71 61 51 52 42 43 33 34 35 25 15 16 26 27 17 7 8 9 19 29 28 38 48 47 46 45 55 54 64 63 73 74 75 76 66 67 77 78 68 58 59 
0 1 1 1 1 0 0 1 1 1 
1 1 1 1 1 1 1 1 0 1 
1 1 1 0 0 1 1 1 1 1 
1 2 0 1 1 1 0 0 1 0 
1 0 1 1 0 1 1 1 1 0 
1 1 1 0 1 1 0 0 1 1 
1 1 0 1 1 0 1 1 1 0 
1 1 0 1 1 1 1 1 1 0 

Complexity: 4
Time: 86 seconds or 1.43 minutes or 0.02 hours