10 9
21
21 12 3 2 1 10 19 18 27 36 37 46 55 56 65 66 67 68 59 60 51 42 41 40 49 48 39 38 29 30 31 22 23 24 15 14 5 6 7 16 17 26 35 34 43 44 53 62 71 70 79 88 87 86 77 76 75 74 83 82 73 64 63 
0 1 1 1 0 1 1 1 0 
0 1 0 1 0 1 1 1 1 
1 1 0 2 1 1 1 0 1 
1 0 1 1 1 0 0 1 1 
1 1 1 1 1 1 1 1 1 
0 1 0 1 1 0 1 0 1 
0 1 1 0 0 1 1 0 1 
1 1 1 1 1 1 0 1 1 
0 1 1 1 1 1 0 1 0 
0 1 1 0 0 1 1 1 0 

Complexity: 4
Time: 2620 seconds or 43.67 minutes or 0.73 hours