10 8
43
43 35 34 26 18 19 20 28 29 30 22 23 15 7 6 5 13 12 4 3 2 1 9 8 16 24 32 33 41 40 48 56 64 65 73 74 75 76 77 78 70 71 63 55 54 62 61 69 68 67 59 58 50 51 52 44 45 37 38 39 
0 1 1 1 1 1 1 1 
1 1 0 0 1 1 0 1 
1 0 1 1 1 0 1 1 
1 0 1 0 1 1 1 0 
1 1 1 1 0 1 1 1 
1 1 0 2 1 1 0 0 
1 0 1 1 1 0 1 1 
1 0 1 1 0 1 1 1 
1 1 0 1 1 1 1 1 
0 1 1 1 1 1 1 0 

Complexity: 4
Time: 327 seconds or 5.44 minutes or 0.09 hours