11 8
50
50 51 52 44 43 42 34 33 25 24 32 40 41 49 57 58 66 65 64 72 73 81 82 74 75 76 77 85 86 87 79 71 70 69 68 60 61 53 54 55 47 39 38 37 29 28 27 19 18 10 9 8 0 1 2 3 4 12 13 14 22 23 15 7 
1 1 1 1 1 0 0 1 
1 1 1 0 1 1 1 1 
0 0 1 1 0 0 1 1 
1 1 0 1 1 1 0 0 
1 1 1 0 0 1 1 1 
1 1 1 1 1 0 0 1 
0 1 2 1 1 1 1 1 
0 1 1 0 1 1 0 0 
1 1 1 0 1 1 1 1 
1 1 1 1 1 1 0 1 
0 1 1 0 0 1 1 1 

Complexity: 4
Time: 451 seconds or 7.51 minutes or 0.13 hours