10 8
26
26 18 17 16 8 0 1 2 10 11 3 4 5 13 14 15 23 22 21 20 28 29 37 36 35 43 42 41 33 32 40 48 49 57 58 59 60 52 53 54 46 38 39 47 55 63 71 79 78 70 69 77 76 75 74 66 65 73 72 
1 1 1 1 1 1 0 0 
1 0 1 1 0 1 1 1 
1 1 1 0 1 1 1 1 
0 0 2 0 1 1 0 0 
1 1 0 1 1 1 1 1 
1 1 1 1 0 0 1 1 
1 1 0 0 1 1 1 1 
0 1 1 1 1 0 0 1 
0 1 1 0 0 1 1 1 
1 1 1 1 1 1 1 1 

Complexity: 4
Time: 175 seconds or 2.92 minutes or 0.05 hours