9 9
46
46 37 38 29 30 21 12 13 22 31 32 41 42 51 60 69 68 77 78 79 80 71 62 61 52 43 44 35 26 17 16 25 24 15 6 5 4 3 2 1 0 9 10 19 18 27 36 45 54 63 72 73 74 75 66 65 56 47 48 49 58 
1 1 1 1 1 1 1 0 0 
1 1 0 1 1 0 1 1 1 
1 1 0 1 1 0 1 1 1 
1 0 1 1 1 1 0 0 1 
1 1 1 0 0 1 1 1 1 
1 2 1 1 1 0 1 1 0 
1 0 1 0 1 0 1 1 1 
1 0 1 1 0 1 1 0 1 
1 1 1 1 0 1 1 1 1 

Complexity: 4
Time: 524 seconds or 8.74 minutes or 0.15 hours