9 10
57
57 47 48 49 39 29 19 18 28 27 17 7 6 16 15 14 4 3 2 12 11 10 20 30 31 21 22 23 24 34 35 36 46 56 55 54 53 43 42 52 51 50 60 61 71 70 80 81 82 83 73 63 64 74 75 85 86 76 77 67 68 69 79 78 88 
0 0 1 1 1 0 1 1 0 0 
1 1 1 0 1 1 1 1 1 1 
1 1 1 1 1 0 0 1 1 1 
1 1 0 0 1 1 1 0 0 1 
0 0 1 1 0 0 1 1 1 1 
1 1 1 1 1 1 1 2 0 0 
1 1 0 1 1 0 0 1 1 1 
1 1 0 1 1 1 1 1 1 1 
1 1 1 1 0 1 1 0 1 0 

Complexity: 4
Time: 2380 seconds or 39.67 minutes or 0.66 hours