10 8
9
9 1 0 8 16 17 18 26 27 19 11 3 4 12 13 5 6 7 15 23 22 21 29 30 38 46 47 55 63 71 79 78 70 69 61 53 52 44 36 35 43 42 41 33 32 40 48 49 57 58 59 67 68 76 75 74 66 65 64 72 
1 1 0 1 1 1 1 1 
1 2 0 1 1 1 0 1 
1 1 1 1 0 1 1 1 
0 0 1 1 0 1 1 0 
1 1 0 1 1 0 1 0 
1 1 1 1 1 0 1 1 
1 1 0 0 1 1 0 1 
0 1 1 1 0 1 0 1 
1 1 1 1 1 1 1 1 
1 0 1 1 1 0 1 1 

Complexity: 4
Time: 168 seconds or 2.8 minutes or 0.05 hours