10 9
38
38 47 48 57 66 75 76 85 86 87 88 89 80 79 70 69 68 59 58 49 40 39 30 21 12 13 14 23 32 33 42 51 52 61 62 53 44 35 34 25 16 17 8 7 6 5 4 3 2 11 10 9 18 19 28 27 36 45 54 55 64 73 74 83 82 81 
0 0 1 1 1 1 1 1 1 
1 1 1 1 1 1 0 1 1 
1 1 0 1 0 1 0 1 0 
1 1 0 1 0 1 1 1 1 
1 0 2 1 1 0 1 0 1 
1 0 1 1 1 0 1 1 1 
1 1 0 1 1 1 0 1 1 
0 1 0 1 0 1 1 1 0 
0 1 1 1 1 0 0 1 1 
1 1 1 0 1 1 1 1 1 

Complexity: 4
Time: 503 seconds or 8.39 minutes or 0.14 hours