9 8
32
32 33 41 40 48 56 64 65 66 67 59 58 50 42 43 35 27 26 18 17 16 8 9 10 2 3 4 12 20 21 29 37 36 44 52 53 61 69 70 71 63 55 54 46 47 39 31 23 22 14 6 7 
0 0 1 1 1 0 1 1 
1 1 1 0 1 0 1 0 
1 1 1 0 1 1 1 1 
0 0 1 1 0 1 0 1 
2 1 0 1 1 1 0 1 
1 1 1 1 1 0 1 1 
1 0 1 0 1 1 1 1 
1 0 1 1 0 1 0 1 
1 1 1 1 0 1 1 1 

Complexity: 3
Time:  4 seconds or 0.07 minutes or 0 hours