11 8
33
33 32 40 48 56 57 49 41 42 43 51 59 60 68 67 66 65 73 72 80 81 82 83 75 76 77 85 86 87 79 71 70 62 54 53 45 37 36 28 20 19 27 26 25 24 16 8 0 1 9 10 2 3 4 12 13 14 6 7 15 23 22 30 38 46 47 
1 1 1 1 1 0 1 1 
1 1 1 0 1 1 1 1 
1 0 0 1 1 0 1 1 
1 1 1 1 1 0 1 0 
1 2 0 0 1 1 1 0 
1 1 1 1 0 1 1 1 
1 1 0 1 0 1 1 0 
1 1 0 1 1 0 1 0 
0 1 1 1 1 0 1 1 
1 1 0 1 1 1 0 1 
1 1 1 1 0 1 1 1 

Complexity: 4
Time: 558 seconds or 9.29 minutes or 0.15 hours