9 10
44
44 54 53 63 62 72 82 81 71 61 60 50 40 41 42 32 31 21 22 23 24 34 35 36 46 56 66 65 64 74 84 85 86 87 77 78 79 69 68 58 59 49 48 47 37 27 28 29 19 9 8 7 6 16 15 14 4 3 2 1 11 10 
0 1 1 1 1 0 1 1 1 1 
1 1 0 0 1 1 1 0 0 1 
0 1 1 1 1 0 0 1 1 1 
0 1 1 0 1 1 1 1 0 0 
1 1 1 0 2 0 1 1 1 1 
1 0 0 1 1 0 1 0 1 1 
1 1 1 1 1 1 1 0 1 1 
0 1 1 0 1 0 0 1 1 1 
0 1 1 0 1 1 1 1 0 0 

Complexity: 4
Time: 649 seconds or 10.81 minutes or 0.18 hours