8 10
21
21 22 23 13 3 4 14 15 5 6 7 8 18 19 29 28 27 26 36 46 45 35 34 33 32 42 52 53 54 64 65 66 67 57 58 48 38 39 49 59 69 79 78 77 76 75 74 73 72 71 61 51 50 40 30 20 10 11 1 
0 1 0 1 1 1 1 1 1 0 
1 1 0 1 1 1 0 0 1 1 
1 2 1 1 0 0 1 1 1 1 
1 0 1 1 1 1 1 0 1 1 
1 0 1 0 0 1 1 0 1 1 
1 1 1 1 1 0 0 1 1 1 
0 1 0 0 1 1 1 1 0 1 
0 1 1 1 1 1 1 1 1 1 

Complexity: 4
Time: 262 seconds or 4.37 minutes or 0.07 hours