9 9
44
44 43 52 61 70 71 80 79 78 69 68 77 76 67 58 49 48 57 66 65 64 73 72 63 54 55 46 45 36 37 38 29 28 19 20 21 22 31 40 41 50 51 42 33 24 25 26 17 16 7 6 5 14 13 4 3 2 1 10 9 
0 1 1 1 1 1 1 1 0 
1 1 0 0 1 1 0 1 1 
0 1 1 1 1 0 1 1 1 
0 1 1 0 1 0 1 0 0 
1 1 1 0 1 1 1 1 2 
1 1 0 1 1 1 1 1 0 
1 1 0 1 1 0 0 1 0 
1 1 1 1 1 1 1 1 1 
1 1 0 0 1 1 1 1 1 

Complexity: 4
Time: 101 seconds or 1.69 minutes or 0.03 hours