8 10
1
1 2 12 13 14 24 23 33 43 42 41 31 21 11 10 20 30 40 50 51 61 60 70 71 72 73 63 53 54 64 65 75 76 77 78 68 69 59 49 39 29 19 18 28 38 37 47 57 56 46 45 35 36 26 16 15 5 6 7 
0 2 1 0 0 1 1 1 0 0 
1 1 1 1 1 1 1 0 1 1 
1 1 0 1 1 0 1 0 1 1 
1 1 0 1 0 1 1 1 1 1 
1 1 1 1 0 1 1 1 0 1 
1 1 0 1 1 0 1 1 0 1 
1 1 0 1 1 1 0 0 1 1 
1 1 1 1 0 1 1 1 1 0 

Complexity: 4
Time: 941 seconds or 15.69 minutes or 0.26 hours