8 10
40
40 50 60 70 71 61 51 52 53 63 73 74 64 65 55 56 66 76 77 78 79 69 59 58 57 47 46 36 37 38 39 29 19 18 8 7 17 16 26 25 15 5 4 3 13 12 22 23 33 34 44 43 42 41 31 30 20 10 11 1 
0 1 0 1 1 1 0 1 1 0 
1 1 1 1 0 1 1 1 1 1 
1 0 1 1 0 1 1 0 0 1 
1 1 0 1 1 0 1 1 1 1 
2 1 1 1 1 0 1 1 0 0 
1 1 1 1 0 1 1 1 1 1 
1 1 0 1 1 1 1 0 0 1 
1 1 0 1 1 0 1 1 1 1 

Complexity: 4
Time: 269 seconds or 4.48 minutes or 0.07 hours