11 8
25
25 24 16 8 0 1 9 10 2 3 4 12 11 19 27 26 34 33 41 40 48 49 50 58 66 65 64 72 73 74 82 83 84 85 77 76 68 69 70 78 79 71 63 55 47 46 54 53 52 60 59 51 43 44 36 37 29 21 22 30 31 23 15 14 6 
1 1 1 1 1 0 1 0 
1 1 1 1 1 0 1 1 
1 0 0 1 0 1 1 1 
1 2 1 1 0 1 1 1 
0 1 1 0 1 1 0 0 
1 1 0 1 1 0 1 1 
1 1 1 1 1 1 1 1 
0 0 1 1 1 0 0 1 
1 1 1 0 1 1 1 1 
1 1 1 0 1 1 1 1 
0 0 1 1 1 1 0 0 

Complexity: 4
Time: 297 seconds or 4.96 minutes or 0.08 hours