10 8
55
55 63 62 70 71 79 78 77 76 68 60 59 51 43 42 50 49 57 65 66 74 73 72 64 56 48 40 32 33 25 24 16 8 9 1 2 10 18 19 20 12 4 5 6 7 15 23 22 21 29 28 27 35 36 37 45 53 54 46 38 39 
0 1 1 0 1 1 1 1 
1 1 1 0 1 0 0 1 
1 0 1 1 1 1 1 1 
1 1 0 1 1 1 0 0 
1 1 0 1 1 1 1 1 
1 0 1 1 0 1 1 0 
1 1 1 1 0 1 1 2 
1 1 0 1 1 0 1 1 
1 1 1 0 1 0 1 1 
1 1 1 0 1 1 1 1 

Complexity: 4
Time: 1631 seconds or 27.18 minutes or 0.45 hours