9 9
68
68 69 60 61 62 53 52 51 42 41 32 33 34 35 26 17 8 7 16 15 14 23 22 13 4 3 2 1 0 9 18 19 10 11 20 29 30 39 48 49 58 67 66 65 56 55 46 37 36 45 54 63 72 73 74 75 76 77 78 79 80 
1 1 1 1 1 0 0 1 1 
1 1 1 0 1 1 1 1 1 
1 1 1 0 1 1 0 0 1 
0 0 1 1 0 1 1 1 1 
1 1 0 1 0 1 1 0 0 
1 1 0 1 1 0 1 1 1 
1 1 1 0 1 0 1 1 1 
1 0 1 1 1 2 1 0 0 
1 1 1 1 1 1 1 1 1 

Complexity: 4
Time: 790 seconds or 13.17 minutes or 0.22 hours