9 10
42
42 52 62 72 73 83 82 81 71 70 60 61 51 41 31 30 20 10 0 1 2 12 22 23 33 43 44 54 64 65 66 76 75 85 86 87 88 89 79 69 68 67 57 58 59 49 39 38 37 27 26 36 46 45 35 25 15 14 4 5 6 7 8 18 19 
1 1 1 0 1 1 1 1 1 0 
1 0 1 0 1 1 0 0 1 1 
1 0 1 1 0 1 1 1 0 0 
1 1 0 1 0 1 1 1 1 1 
0 1 2 1 1 1 1 0 0 1 
0 1 1 0 1 0 0 1 1 1 
1 1 1 0 1 1 1 1 1 1 
1 1 1 1 0 1 1 0 0 1 
0 1 1 1 0 1 1 1 1 1 

Complexity: 4
Time: 1726 seconds or 28.76 minutes or 0.48 hours