9 8
39
39 31 23 15 7 6 5 4 12 13 21 20 19 11 10 2 1 0 8 9 17 25 26 34 33 32 40 48 49 57 65 66 58 50 51 43 44 36 28 29 30 38 46 47 55 54 53 61 60 68 69 70 71 
1 1 1 0 1 1 1 1 
1 1 1 1 1 1 0 1 
0 1 0 1 1 1 0 1 
0 1 1 0 1 1 1 1 
1 1 1 0 1 0 1 2 
1 0 0 1 1 0 1 1 
1 1 1 1 0 1 1 1 
0 1 1 0 1 1 0 0 
0 1 1 0 1 1 1 1 

Complexity: 3
Time: 21 seconds or 0.36 minutes or 0.01 hours