11 8
19
19 11 12 13 21 29 30 38 46 54 55 47 39 31 23 15 7 6 5 4 3 2 1 0 8 9 17 16 24 32 33 25 26 27 35 36 44 43 42 41 49 48 56 57 65 66 58 59 60 52 53 61 69 70 71 79 78 86 85 77 76 75 83 82 81 73 72 
1 1 1 1 1 1 1 1 
1 1 0 1 1 1 0 1 
1 1 0 2 0 1 0 1 
1 1 1 1 0 1 1 1 
1 1 0 1 1 0 1 1 
0 1 1 1 1 0 1 1 
1 1 0 0 1 1 1 1 
1 1 1 1 1 1 0 0 
0 1 1 0 0 1 1 1 
1 1 0 1 1 1 1 1 
0 1 1 1 0 1 1 0 

Complexity: 4
Time: 3520 seconds or 58.66 minutes or 0.98 hours