9 10
39
39 29 19 18 8 7 6 5 15 25 26 27 37 38 48 58 59 69 79 89 88 78 68 67 57 56 46 45 44 34 24 14 13 23 22 12 2 1 0 10 20 30 31 41 42 43 53 52 51 61 60 70 71 81 82 83 84 74 73 63 64 65 75 76 86 
1 1 1 0 0 1 1 1 1 0 
1 0 1 1 1 1 0 0 1 1 
1 0 1 1 1 1 1 1 0 1 
1 1 0 0 1 0 0 1 1 2 
0 1 1 1 1 1 1 0 1 0 
0 1 1 1 0 0 1 1 1 1 
1 1 0 1 1 1 0 1 1 1 
1 1 0 1 1 1 1 0 1 1 
0 1 1 1 1 0 1 0 1 1 

Complexity: 4
Time: 2383 seconds or 39.71 minutes or 0.66 hours