8 10
19
19 29 39 38 48 58 59 69 79 78 77 67 57 56 66 76 75 74 73 72 71 61 51 50 40 30 20 21 11 10 0 1 2 12 13 14 4 5 6 16 15 25 24 34 33 32 42 52 62 63 64 54 44 45 35 36 37 27 17 18 8 
1 1 1 0 1 1 1 0 1 0 
1 1 1 1 1 1 1 1 1 2 
1 1 0 0 1 1 0 1 0 1 
1 0 1 1 1 1 1 1 1 1 
1 0 1 0 1 1 0 0 1 0 
1 1 1 0 1 0 1 1 1 1 
0 1 1 1 1 0 1 1 0 1 
0 1 1 1 1 1 1 1 1 1 

Complexity: 4
Time: 1103 seconds or 18.38 minutes or 0.31 hours