10 9
16
16 17 26 25 34 43 44 53 52 51 60 61 62 71 80 89 88 87 78 69 68 77 76 85 84 83 82 81 72 73 64 65 66 57 58 49 40 41 32 23 24 15 6 5 4 13 12 21 30 29 38 47 46 55 54 45 36 27 18 19 10 9 0 1 2 
1 1 1 0 1 1 1 0 0 
1 1 0 1 1 0 1 2 1 
1 1 0 1 0 1 1 1 1 
1 0 1 1 0 1 0 1 0 
1 0 1 0 1 1 0 1 1 
1 1 1 0 1 0 1 1 1 
1 1 0 1 1 0 1 1 1 
0 1 1 1 0 1 1 0 1 
1 1 0 0 1 1 1 0 1 
1 1 1 1 1 0 1 1 1 

Complexity: 4
Time: 271 seconds or 4.51 minutes or 0.08 hours