10 8
21
21 20 12 4 5 13 14 15 23 31 39 47 46 38 37 29 28 27 26 34 42 43 44 52 53 61 62 63 71 70 78 77 76 68 67 59 58 66 74 73 72 64 65 57 49 41 40 32 24 16 17 9 10 11 3 2 1 0 
1 1 1 1 1 1 0 0 
0 1 1 1 1 1 1 1 
1 1 0 0 1 2 0 1 
1 0 1 1 1 1 0 1 
1 0 1 0 0 1 1 1 
1 1 1 1 1 0 1 1 
0 1 0 0 1 1 0 0 
0 1 1 1 0 1 1 1 
1 1 1 1 1 0 1 1 
1 1 1 0 1 1 1 0 

Complexity: 4
Time: 15 seconds or 0.26 minutes or 0 hours