9 9
6
6 7 8 17 26 35 34 43 42 51 52 61 62 71 70 79 78 77 68 59 58 49 40 39 38 47 56 65 66 75 74 73 64 63 54 45 46 37 28 29 20 21 22 23 32 33 24 15 14 5 4 3 2 11 10 9 18 
0 0 1 1 1 1 2 1 1 
1 1 1 0 0 1 1 0 1 
1 0 1 1 1 1 1 0 1 
0 1 1 0 0 1 1 1 1 
0 1 1 1 1 0 1 1 0 
1 1 1 0 1 0 1 1 0 
1 0 1 0 1 1 0 1 1 
1 1 1 1 0 1 0 1 1 
0 1 1 1 0 1 1 1 0 

Complexity: 4
Time: 359 seconds or 5.98 minutes or 0.1 hours