9 9
15
15 14 23 22 21 30 31 40 39 38 47 56 55 64 73 72 63 54 45 36 27 28 19 18 9 0 1 2 11 12 13 4 5 6 7 8 17 26 25 34 33 42 51 50 49 58 67 66 75 76 77 78 69 60 61 70 79 80 71 62 53 44 
1 1 1 0 1 1 1 1 1 
1 0 1 1 1 1 2 0 1 
1 1 0 1 1 1 0 1 1 
1 1 0 1 1 0 1 1 0 
1 0 1 1 1 0 1 0 1 
1 0 1 0 1 1 1 0 1 
1 1 1 0 1 0 1 1 1 
1 1 0 1 1 0 1 1 1 
1 1 0 1 1 1 1 1 1 

Complexity: 4
Time: 852 seconds or 14.21 minutes or 0.24 hours