10 8
37
37 29 21 13 12 4 3 2 1 9 8 16 24 32 33 25 17 18 19 27 35 36 44 52 51 50 42 41 49 48 56 57 65 64 72 73 74 75 67 59 60 61 69 77 78 70 62 63 55 54 46 47 39 31 23 22 14 6 7 
0 1 1 1 1 0 1 1 
1 1 0 0 1 1 1 0 
1 1 1 1 0 1 1 1 
1 1 0 1 0 1 0 1 
1 1 0 1 1 2 0 1 
0 1 1 0 1 0 1 1 
1 1 1 1 1 0 1 1 
1 1 0 1 1 1 1 1 
1 1 0 1 0 1 1 0 
1 1 1 1 0 1 1 0 

Complexity: 4
Time: 73 seconds or 1.21 minutes or 0.02 hours