8 10
34
34 33 43 44 54 55 65 66 67 77 76 75 74 64 63 73 72 71 70 60 61 51 52 42 41 40 30 20 21 22 12 11 1 2 3 13 14 24 25 15 5 6 16 17 7 8 9 19 29 28 38 37 36 46 47 48 58 59 69 79 
0 1 1 1 0 1 1 1 1 1 
0 1 1 1 1 1 1 1 0 1 
1 1 1 0 1 1 0 0 1 1 
1 0 0 1 2 0 1 1 1 0 
1 1 1 1 1 0 1 1 1 0 
0 1 1 0 1 1 0 0 1 1 
1 1 0 1 1 1 1 1 0 1 
1 1 1 1 1 1 1 1 0 1 

Complexity: 4
Time: 423 seconds or 7.04 minutes or 0.12 hours