8 10
31
31 32 42 52 62 61 71 70 60 50 40 30 20 21 11 10 0 1 2 3 4 5 6 7 8 9 19 29 28 27 26 16 15 14 13 23 33 34 35 45 44 54 64 63 73 74 75 76 77 67 66 56 57 47 37 38 48 58 59 69 79 
1 1 1 1 1 1 1 1 1 1 
1 1 0 1 1 1 1 0 0 1 
1 1 0 1 0 0 1 1 1 1 
1 2 1 1 1 1 0 1 1 0 
1 0 1 0 1 1 0 1 1 0 
1 0 1 0 1 0 1 1 1 1 
1 1 1 1 1 0 1 1 0 1 
1 1 0 1 1 1 1 1 0 1 

Complexity: 4
Time: 789 seconds or 13.16 minutes or 0.22 hours