9 8
64
64 56 48 49 57 65 66 58 59 67 68 69 70 62 63 55 47 46 54 53 52 44 43 42 34 33 32 24 25 26 18 19 20 28 36 37 38 30 22 23 15 7 6 14 13 12 4 3 2 10 9 8 0 
1 0 1 1 1 0 1 1 
1 1 1 0 1 1 1 1 
0 0 1 1 1 0 1 1 
1 1 1 0 1 0 1 0 
1 1 1 0 1 1 1 0 
0 0 1 1 1 0 1 1 
1 1 0 0 1 1 1 1 
1 1 1 1 0 0 1 1 
2 1 1 1 1 1 1 0 

Complexity: 3
Time: 16 seconds or 0.26 minutes or 0 hours