11 8
50
50 58 57 49 48 56 64 72 73 81 82 74 75 67 68 76 77 85 86 78 79 71 63 55 47 46 54 62 61 60 52 44 43 42 34 33 32 24 16 17 18 19 27 28 29 37 38 30 22 23 15 14 6 5 13 12 11 10 2 1 0 
1 1 1 0 0 1 1 0 
0 0 1 1 1 1 1 1 
1 1 1 1 0 0 1 1 
1 0 0 1 1 1 1 0 
1 1 1 0 0 1 1 0 
0 0 1 1 1 0 1 1 
1 1 2 0 1 0 1 1 
1 1 1 0 1 1 1 1 
1 0 0 1 1 0 0 1 
1 1 1 1 1 1 1 1 
0 1 1 0 0 1 1 0 

Complexity: 4
Time: 120 seconds or 2 minutes or 0.03 hours