10 9
81
81 72 73 82 83 84 85 76 77 78 87 88 79 80 71 70 69 60 61 52 53 44 35 34 25 16 17 8 7 6 15 14 5 4 3 12 13 22 31 32 33 42 41 50 49 58 67 66 57 56 65 64 55 46 45 36 37 38 39 30 29 20 19 18 9 10 1 
0 1 0 1 1 1 1 1 1 
1 1 0 1 1 1 1 1 1 
1 1 1 0 1 0 0 1 0 
0 0 1 1 1 1 1 1 1 
1 1 1 1 0 1 1 0 1 
1 1 0 0 1 1 0 1 1 
0 1 1 1 1 0 1 1 0 
0 1 1 1 1 0 1 1 1 
1 1 0 0 1 1 1 1 1 
2 1 1 1 1 0 1 1 0 

Complexity: 4
Time: 271 seconds or 4.52 minutes or 0.08 hours