9 10
73
73 74 75 65 66 56 46 47 57 58 59 69 79 89 88 78 77 76 86 85 84 83 82 81 80 70 60 50 51 61 62 52 42 43 53 54 44 34 35 36 26 27 28 38 39 29 19 18 8 7 6 5 15 14 4 3 13 23 22 12 11 21 31 30 20 10 0 
1 0 0 1 1 1 1 1 1 0 
1 1 1 1 1 1 0 0 1 1 
1 1 1 1 0 0 1 1 1 1 
1 1 0 0 1 1 1 0 1 1 
0 0 1 1 1 0 1 1 0 0 
1 1 1 1 1 0 1 1 1 1 
1 1 1 0 0 1 1 0 0 1 
1 0 0 2 1 1 1 1 1 1 
1 1 1 1 1 1 1 0 1 1 

Complexity: 4
Time: 132 seconds or 2.21 minutes or 0.04 hours