8 10
71
71 70 60 61 51 50 40 30 31 32 22 23 33 43 44 54 53 52 62 72 73 74 75 65 66 76 77 78 79 69 59 58 57 47 46 45 35 25 26 27 37 38 39 29 19 18 17 7 6 5 15 14 4 3 2 1 11 10 
0 1 1 1 1 1 1 1 0 0 
1 1 0 0 1 1 0 1 1 1 
0 0 1 1 0 1 1 1 0 1 
1 1 1 1 0 1 0 1 1 1 
1 0 0 1 1 1 1 1 0 0 
1 1 1 1 1 0 0 1 1 1 
1 1 1 0 0 1 1 0 0 1 
1 2 1 1 1 1 1 1 1 1 

Complexity: 4
Time: 324 seconds or 5.4 minutes or 0.09 hours