10 8
44
44 43 51 52 53 61 69 70 78 79 71 63 55 47 46 38 37 36 28 27 35 34 33 41 49 57 58 66 67 68 76 75 74 73 72 64 56 48 40 32 24 16 8 0 1 9 17 18 19 11 3 4 5 6 7 15 14 13 21 22 30 31 
1 1 0 1 1 1 1 1 
1 1 0 1 0 1 1 1 
1 1 1 1 0 1 1 0 
1 0 0 1 1 0 1 1 
1 1 1 1 1 1 1 0 
1 1 0 1 2 0 1 1 
1 1 0 1 1 1 0 1 
1 1 1 0 0 1 0 1 
1 0 1 1 1 1 1 1 
1 1 1 1 1 0 1 1 

Complexity: 4
Time: 9493 seconds or 158.22 minutes or 2.64 hours