11 8
72
72 80 81 73 65 66 58 57 56 48 49 41 40 32 24 16 17 9 8 0 1 2 3 4 5 13 12 11 19 20 28 27 26 34 35 43 51 52 60 68 69 77 76 75 83 84 85 86 87 79 71 63 62 54 46 45 37 38 39 31 30 22 23 15 7 
1 1 1 1 1 1 0 1 
1 1 0 1 1 1 0 1 
1 1 0 1 1 0 1 1 
1 0 1 1 1 0 1 1 
1 0 1 1 0 1 1 1 
1 1 0 1 0 1 1 0 
1 1 0 1 1 0 1 0 
1 1 1 0 1 0 1 1 
0 1 1 0 1 1 0 1 
2 1 0 1 1 1 0 1 
1 1 0 1 1 1 1 1 

Complexity: 4
Time: 16843 seconds or 280.72 minutes or 4.68 hours