10 9
83
83 82 81 72 73 64 55 46 45 36 27 28 19 18 9 0 1 2 11 12 13 22 23 14 5 6 15 16 17 26 35 34 33 42 51 52 53 62 61 70 71 80 89 88 87 78 77 68 59 50 49 40 31 30 29 38 47 56 57 66 75 76 85 
1 1 1 0 0 1 1 0 0 
1 0 1 1 1 1 1 1 1 
1 1 0 0 1 1 0 0 1 
1 1 1 1 1 0 1 1 1 
1 0 1 0 1 0 1 0 0 
1 1 1 0 1 1 1 1 1 
0 1 1 1 0 1 0 1 1 
0 1 0 1 0 1 0 1 1 
1 1 0 1 1 1 1 0 1 
1 1 2 0 1 0 1 1 1 

Complexity: 4
Time: 774 seconds or 12.89 minutes or 0.21 hours