9 9
25
25 26 17 16 7 6 5 14 13 22 23 32 41 40 31 30 39 48 57 56 47 38 37 28 19 20 21 12 11 2 1 10 9 18 27 36 45 54 63 64 73 74 75 76 67 58 59 68 77 78 79 80 71 70 61 60 51 42 33 34 35 44 53 
0 1 1 0 0 1 1 1 0 
1 1 1 1 1 1 0 1 1 
1 1 1 1 1 1 0 2 1 
1 1 0 1 1 1 1 1 1 
1 1 1 1 1 1 1 0 1 
1 0 1 1 0 0 1 0 1 
1 0 1 1 1 1 1 1 0 
1 1 0 0 1 1 0 1 1 
0 1 1 1 1 1 1 1 1 

Complexity: 4
Time: 25303 seconds or 421.72 minutes or 7.03 hours