10 9
22
22 23 14 5 6 7 8 17 26 25 24 33 34 43 44 53 62 71 70 61 52 51 50 41 40 49 58 59 68 77 78 79 88 87 86 85 84 75 66 65 64 55 46 47 48 39 30 21 20 11 12 3 2 1 10 9 18 27 28 37 36 45 54 63 72 73 82 
0 1 1 1 0 1 1 1 1 
1 1 1 1 0 1 0 0 1 
1 0 1 1 2 1 1 1 1 
1 1 0 1 0 0 1 1 0 
1 1 0 1 1 1 0 1 1 
1 1 1 1 1 1 1 1 1 
1 1 0 0 1 1 0 1 1 
1 1 1 1 0 1 0 1 1 
1 1 0 1 0 1 1 1 0 
0 1 0 1 1 1 1 1 0 

Complexity: 4
Time: 195 seconds or 3.25 minutes or 0.05 hours