9 9
42
42 43 34 35 44 53 62 71 70 79 78 77 76 75 74 73 64 63 54 45 46 55 56 57 66 67 68 69 60 51 50 49 40 39 38 29 28 27 18 19 10 1 2 11 20 21 30 31 32 23 24 15 14 13 4 5 6 7 16 17 
0 1 1 0 1 1 1 1 0 
0 1 1 0 1 1 1 1 1 
1 1 1 1 0 1 1 0 0 
1 1 1 1 1 1 0 1 1 
0 0 1 1 1 0 2 1 1 
1 1 0 0 1 1 1 0 1 
1 1 1 1 0 0 1 0 1 
1 1 0 1 1 1 1 1 1 
0 1 1 1 1 1 1 1 0 

Complexity: 4
Time: 128 seconds or 2.13 minutes or 0.04 hours