9 8
2
2 1 0 8 16 24 25 33 41 49 48 56 64 65 66 58 50 51 43 44 36 35 27 26 18 10 11 3 4 12 20 21 29 30 38 46 54 53 61 60 68 69 70 71 63 55 47 39 31 23 22 14 6 7 
1 1 2 1 1 0 1 1 
1 0 1 1 1 0 1 0 
1 0 1 0 1 1 1 1 
1 1 1 1 0 1 1 1 
0 1 0 1 1 0 1 1 
0 1 0 1 1 0 1 1 
1 1 1 1 0 1 1 1 
1 0 1 0 1 1 0 1 
1 1 1 0 1 1 1 1 

Complexity: 3
Time: 74 seconds or 1.24 minutes or 0.02 hours