9 9
17
17 16 7 6 5 4 3 12 13 22 23 24 33 34 35 44 53 62 61 52 51 50 41 40 39 30 21 20 11 10 1 0 9 18 27 28 37 38 47 46 45 54 63 72 73 64 65 74 75 66 57 58 67 76 77 68 69 78 79 80 
1 1 0 1 1 1 1 1 0 
1 1 1 1 1 0 0 1 2 
1 0 1 1 1 1 1 0 0 
1 1 0 1 0 0 1 1 1 
0 1 1 1 1 1 0 0 1 
1 1 1 0 0 1 1 1 1 
1 0 0 1 1 0 0 1 1 
1 1 1 1 1 1 1 0 0 
1 1 1 1 1 1 1 1 1 

Complexity: 4
Time: 456 seconds or 7.6 minutes or 0.13 hours