8 10
11
11 12 13 23 22 32 33 34 44 54 64 63 73 74 75 65 66 67 77 78 79 69 59 58 57 47 46 45 35 25 26 27 28 38 39 29 19 9 8 7 17 16 15 5 4 3 2 1 0 10 20 30 40 41 42 52 51 61 71 70 
1 1 1 1 1 1 0 1 1 1 
1 2 1 1 0 1 1 1 0 1 
1 0 1 1 0 1 1 1 1 1 
1 0 1 1 1 1 0 0 1 1 
1 1 1 0 1 1 1 1 0 0 
0 1 1 0 1 0 0 1 1 1 
0 1 0 1 1 1 1 1 0 1 
1 1 0 1 1 1 0 1 1 1 

Complexity: 4
Time: 487 seconds or 8.11 minutes or 0.14 hours