8 10
48
48 47 46 56 66 65 75 76 77 78 79 69 68 58 59 49 39 38 28 18 17 16 26 36 35 34 44 54 53 63 73 72 71 61 60 50 51 52 42 32 31 30 20 10 0 1 11 12 2 3 13 23 24 14 4 5 6 7 8 9 
1 1 1 1 1 1 1 1 1 1 
1 1 1 1 1 0 1 1 1 0 
1 0 0 1 1 0 1 0 1 0 
1 1 1 0 1 1 1 0 1 1 
0 0 1 0 1 0 1 1 2 1 
1 1 1 1 1 0 1 0 1 1 
1 1 0 1 0 1 1 0 1 1 
0 1 1 1 0 1 1 1 1 1 

Complexity: 4
Time: 90 seconds or 1.51 minutes or 0.03 hours