9 9
48
48 49 58 59 68 77 78 79 70 71 62 61 52 51 42 43 44 35 26 17 16 7 6 5 4 3 2 1 10 9 18 27 28 19 20 21 12 13 14 15 24 33 32 31 40 39 38 47 46 45 54 55 64 65 66 75 74 73 72 
0 1 1 1 1 1 1 1 0 
1 1 0 1 1 1 1 1 1 
1 1 1 1 0 0 1 0 1 
1 1 0 0 1 1 1 0 1 
0 0 1 1 1 0 1 1 1 
1 1 1 2 1 0 1 1 0 
1 1 0 0 1 1 0 1 1 
0 1 1 1 0 1 0 1 1 
1 1 1 1 0 1 1 1 0 

Complexity: 4
Time: 291 seconds or 4.85 minutes or 0.08 hours