9 9
19
19 28 27 18 9 10 1 2 3 4 5 6 7 8 17 26 35 34 25 24 15 14 13 12 21 30 29 38 39 48 49 40 31 32 41 42 43 52 53 62 61 70 79 78 69 60 59 68 67 66 75 74 73 72 63 64 65 56 55 46 45 
0 1 1 1 1 1 1 1 1 
1 1 0 1 1 1 1 0 1 
1 2 0 1 0 0 1 1 1 
1 1 1 1 1 1 0 1 1 
0 0 1 1 1 1 1 1 0 
1 1 0 1 1 0 0 1 1 
0 1 1 0 0 1 1 1 1 
1 1 1 1 1 1 1 1 0 
1 1 1 1 0 0 1 1 0 

Complexity: 4
Time: 197 seconds or 3.29 minutes or 0.05 hours