8 10
73
73 74 75 76 66 65 55 45 35 36 37 47 57 58 68 78 79 69 59 49 39 29 28 18 19 9 8 7 17 16 6 5 4 14 15 25 24 23 13 12 11 1 0 10 20 30 40 50 51 41 31 32 42 43 44 54 64 63 62 72 71 70 
1 1 0 0 1 1 1 1 1 1 
1 1 1 1 1 1 1 1 1 1 
1 0 0 1 1 1 0 0 1 1 
1 1 1 0 0 1 1 1 0 1 
1 1 1 1 1 1 0 1 0 1 
1 1 0 0 1 1 0 1 1 1 
0 0 1 1 1 1 1 0 1 1 
1 1 1 2 1 1 1 0 1 1 

Complexity: 4
Time: 712 seconds or 11.86 minutes or 0.2 hours