10 8
13
13 14 6 7 15 23 31 30 29 37 38 46 54 55 63 62 61 69 68 67 66 58 50 51 52 44 36 35 34 26 18 19 20 12 4 3 11 10 9 1 0 8 16 24 32 33 41 49 48 56 64 72 73 74 75 76 77 78 79 
1 1 0 1 1 0 1 1 
1 1 1 1 1 2 1 1 
1 0 1 1 1 0 0 1 
1 0 1 0 0 1 1 1 
1 1 1 1 1 1 1 0 
0 1 0 0 1 0 1 0 
1 1 1 1 1 0 1 1 
1 0 1 0 0 1 1 1 
1 0 1 1 1 1 0 0 
1 1 1 1 1 1 1 1 

Complexity: 4
Time: 146 seconds or 2.43 minutes or 0.04 hours