11 8
70
70 71 79 78 86 85 77 76 75 67 68 69 61 53 54 55 47 46 38 30 29 21 22 23 15 7 6 14 13 12 4 3 2 1 0 8 9 10 18 19 27 35 36 44 52 51 43 42 41 33 25 24 32 40 48 56 57 58 66 65 73 74 82 81 80 
1 1 1 1 1 0 1 1 
1 1 1 0 1 1 1 1 
0 0 1 1 0 1 1 1 
1 1 0 1 0 1 1 0 
1 1 0 1 1 0 1 0 
1 1 1 1 1 0 1 1 
1 0 0 1 1 1 1 1 
1 1 1 0 0 1 0 0 
0 1 1 1 1 1 2 1 
0 1 1 1 1 1 1 1 
1 1 1 0 0 1 1 0 

Complexity: 4
Time: 783 seconds or 13.04 minutes or 0.22 hours