10 8
47
47 39 31 30 22 14 15 7 6 5 13 21 20 12 11 3 2 1 0 8 16 17 18 26 27 35 36 37 45 53 54 55 63 62 70 78 77 76 75 67 68 60 52 51 43 42 41 33 32 40 48 56 57 58 66 65 73 72 
1 1 1 1 0 1 1 1 
1 0 0 1 1 1 1 1 
1 1 1 0 1 1 1 0 
0 0 1 1 0 0 1 1 
1 1 0 1 1 1 0 1 
1 1 1 1 0 1 0 2 
1 0 0 1 1 1 1 1 
1 1 1 0 1 0 1 1 
0 1 1 1 1 0 1 0 
1 1 0 1 1 1 1 0 

Complexity: 4
Time: 1274 seconds or 21.23 minutes or 0.35 hours