10 8
14
14 15 7 6 5 4 3 2 1 0 8 16 24 32 33 25 26 18 10 11 12 20 28 29 30 22 23 31 39 47 46 45 53 52 44 36 35 43 42 41 49 57 56 64 65 73 74 66 58 59 67 68 76 77 69 61 62 63 71 79 
1 1 1 1 1 1 1 1 
1 0 1 1 1 0 2 1 
1 0 1 0 1 0 1 1 
1 1 1 0 1 1 1 1 
1 1 0 1 1 0 0 1 
0 1 1 1 1 1 1 1 
0 1 0 0 1 1 0 0 
1 1 1 1 0 1 1 1 
1 1 1 1 1 1 0 1 
0 1 1 0 1 1 0 1 

Complexity: 4
Time: 193 seconds or 3.21 minutes or 0.05 hours