9 8
6
6 7 15 23 31 39 47 46 38 30 29 21 13 5 4 12 11 10 2 1 0 8 9 17 18 26 27 28 36 44 43 42 50 49 41 33 25 24 32 40 48 56 57 65 66 67 59 60 52 53 61 69 70 62 63 
1 1 1 0 1 1 2 1 
1 1 1 1 1 1 0 1 
0 1 1 0 0 1 0 1 
1 1 1 1 1 1 1 1 
1 1 0 0 1 0 1 1 
1 1 1 1 1 0 1 1 
1 1 1 0 1 1 0 0 
1 1 0 1 1 1 1 1 
0 1 1 1 0 1 1 0 

Complexity: 3
Time:  4 seconds or 0.06 minutes or 0 hours