11 8
76
76 68 69 77 85 86 87 79 71 63 62 61 53 54 46 47 39 31 23 22 21 29 37 36 44 43 51 59 58 66 67 75 83 82 81 73 72 64 56 57 49 41 40 32 33 34 26 27 19 18 17 16 8 9 1 2 3 4 12 13 14 15 7 
0 1 1 1 1 0 0 1 
1 1 0 0 1 1 1 1 
1 1 1 1 0 1 1 1 
0 0 1 1 0 1 0 1 
1 1 1 0 1 1 0 1 
1 1 0 1 1 0 1 1 
0 1 0 1 0 1 1 0 
1 1 1 1 0 1 1 1 
1 0 1 1 1 1 0 1 
1 1 0 1 2 1 0 1 
0 1 1 1 0 1 1 1 

Complexity: 4
Time: 894 seconds or 14.91 minutes or 0.25 hours