8 10
11
11 21 20 10 0 1 2 3 4 5 15 14 24 23 22 32 42 43 44 45 35 36 26 27 17 7 8 9 19 29 39 38 37 47 48 49 59 58 68 69 79 78 77 76 66 56 55 54 64 74 73 63 62 72 71 70 60 61 51 41 40 
1 1 1 1 1 1 0 1 1 1 
1 2 0 0 1 1 0 1 0 1 
1 1 1 1 1 0 1 1 0 1 
0 0 1 0 0 1 1 1 1 1 
1 1 1 1 1 1 0 1 1 1 
0 1 0 0 1 1 1 0 1 1 
1 1 1 1 1 0 1 0 1 1 
1 1 1 1 1 0 1 1 1 1 

Complexity: 4
Time: 251 seconds or 4.18 minutes or 0.07 hours