9 9
11
11 10 1 0 9 18 27 36 37 28 29 30 21 12 3 4 5 14 23 32 31 40 41 50 59 58 57 48 47 56 55 54 63 72 73 74 75 66 67 68 69 78 79 80 71 62 61 52 53 44 43 42 33 24 25 26 17 16 7 
1 1 0 1 1 1 0 1 0 
1 1 2 1 0 1 0 1 1 
1 0 0 1 0 1 1 1 1 
1 1 1 1 1 1 1 0 0 
1 1 0 0 1 1 1 1 1 
0 0 1 1 0 1 0 1 1 
1 1 1 1 1 1 0 1 1 
1 0 0 1 1 1 1 0 1 
1 1 1 1 0 0 1 1 1 

Complexity: 4
Time: 29 seconds or 0.48 minutes or 0.01 hours