10 9
13
13 22 23 24 33 34 35 26 17 16 15 6 5 4 3 12 11 20 29 30 31 40 41 50 49 48 47 56 57 66 67 68 69 60 61 52 43 44 53 62 71 80 79 88 87 78 77 76 75 84 83 82 73 64 63 54 45 36 37 28 27 18 9 10 1 
0 1 0 1 1 1 1 0 0 
1 1 1 1 2 0 1 1 1 
1 0 1 0 1 1 1 0 1 
1 1 1 1 1 0 1 1 1 
1 1 0 0 1 1 0 1 1 
1 0 1 1 1 1 0 1 1 
1 0 1 1 0 0 1 1 1 
1 1 0 1 1 1 1 0 1 
0 1 0 1 1 1 1 1 1 
0 1 1 1 0 0 1 1 0 

Complexity: 4
Time: 514 seconds or 8.57 minutes or 0.14 hours