10 8
49
49 48 40 32 33 34 26 27 19 18 17 16 8 0 1 2 3 11 12 13 5 6 7 15 23 22 30 31 39 47 46 38 37 29 28 36 44 43 51 50 58 57 56 64 72 73 74 75 67 59 60 68 76 77 78 70 71 63 62 54 53 
1 1 1 1 0 1 1 1 
1 0 0 1 1 1 0 1 
1 1 1 1 0 0 1 1 
0 0 1 1 1 1 1 1 
1 1 1 0 1 1 1 1 
1 0 0 1 1 0 1 1 
1 2 1 1 0 1 1 0 
1 1 1 1 1 0 1 1 
1 0 0 1 1 0 1 1 
1 1 1 1 1 1 1 0 

Complexity: 4
Time: 317 seconds or 5.28 minutes or 0.09 hours1 1 1 1 1 1 1 1 1 1 
1 1 1 1 1 1 1 1 1 1 

Complexity: 4
Time:  0 seconds or 0 minutes or 0 hours