10 8
52
52 51 43 35 27 28 36 37 45 53 61 60 59 58 50 49 48 40 41 33 32 24 25 26 18 17 16 8 9 1 2 3 11 12 13 5 6 14 15 23 22 21 29 30 31 39 47 46 54 55 63 71 79 78 77 69 68 76 75 74 66 65 64 
0 1 1 1 0 1 1 0 
1 1 0 1 1 1 1 1 
1 1 1 0 0 1 1 1 
1 1 1 1 1 1 1 1 
1 1 0 1 1 1 0 1 
1 1 0 1 0 1 1 1 
1 1 1 1 2 1 1 1 
0 0 1 1 1 1 0 1 
1 1 1 0 1 1 0 1 
0 0 1 1 1 1 1 1 

Complexity: 4
Time: 316 seconds or 5.27 minutes or 0.09 hours 1 1 1 1 
1 1 1 1 1 1 1 1 

Complexity: 4
Time:  0 seconds or 0 minutes or 0 hours