10 8
9
9 8 0 1 2 10 18 17 16 24 32 33 34 42 50 49 48 56 57 65 64 72 73 74 75 67 59 60 61 69 77 78 79 71 63 62 54 53 52 44 36 35 27 19 20 12 4 5 6 7 15 14 22 23 31 30 29 37 38 39 47 
1 1 1 0 1 1 1 1 
1 2 1 0 1 0 1 1 
1 1 1 1 1 0 1 1 
1 0 0 1 0 1 1 1 
1 1 1 1 1 1 1 1 
0 0 1 0 1 0 0 1 
1 1 1 0 1 1 1 0 
1 1 0 1 1 1 1 1 
1 1 0 1 0 1 0 1 
1 1 1 1 0 1 1 1 

Complexity: 4
Time: 347 seconds or 5.78 minutes or 0.1 hours1 
1 1 1 1 1 1 1 1 
1 1 1 1 1 1 1 1 

Complexity: 4
Time:  0 seconds or 0 minutes or 0 hours