8 10
57
57 58 59 69 79 78 77 67 66 76 75 74 73 63 62 72 71 70 60 50 51 41 40 30 20 21 22 32 33 34 44 43 53 54 55 45 46 47 37 38 39 29 19 18 8 7 17 16 26 25 15 5 4 14 13 12 2 1 0 
1 1 1 0 1 1 0 1 1 0 
0 0 1 1 1 1 1 1 1 1 
1 1 1 0 0 1 1 0 0 1 
1 0 1 1 1 0 0 1 1 1 
1 1 0 1 1 1 1 1 0 0 
1 1 0 1 1 1 0 2 1 1 
1 0 1 1 0 0 1 1 0 1 
1 1 1 1 1 1 1 1 1 1 

Complexity: 4
Time: 158 seconds or 2.63 minutes or 0.04 hours
Complexity: 4
Time: 158 seconds or 2.64 minutes or 0.04 hours