10 8
52
52 53 61 60 68 76 77 78 70 71 63 55 47 46 38 30 29 28 36 44 43 51 59 58 66 74 73 72 64 56 48 49 41 40 32 24 16 17 25 33 34 35 27 19 11 10 9 1 2 3 4 12 13 14 22 23 15 7 
0 1 1 1 1 0 0 1 
0 1 1 1 1 1 1 1 
1 1 0 1 0 0 1 1 
1 1 0 1 1 1 1 0 
1 1 1 1 1 0 1 0 
1 1 0 1 1 0 1 1 
1 1 0 1 2 1 0 1 
1 0 1 1 1 1 0 1 
1 0 1 0 1 0 1 1 
1 1 1 0 1 1 1 0 

Complexity: 4
Time: 109 seconds or 1.81 minutes or 0.03 hours