11 8
73
73 65 66 58 59 51 52 53 45 44 36 28 27 19 11 10 2 1 0 8 9 17 25 24 32 33 34 42 41 49 48 56 64 72 80 81 82 83 75 76 68 69 77 85 86 87 79 71 70 62 54 55 47 39 38 30 31 23 22 21 13 12 4 5 6 7 
1 1 1 0 1 1 1 1 
1 1 1 1 1 1 0 0 
0 1 0 1 0 1 1 1 
1 1 0 1 1 0 1 1 
1 1 1 0 1 0 1 1 
0 1 1 0 1 1 0 1 
1 1 0 1 1 1 1 1 
1 0 1 1 0 0 1 0 
1 1 1 0 1 1 1 1 
1 2 0 1 1 1 0 1 
1 1 1 1 0 1 1 1 

Complexity: 4
Time: 846 seconds or 14.11 minutes or 0.24 hours