9 8
14
14 15 7 6 5 4 3 11 10 9 1 0 8 16 17 25 24 32 33 34 42 50 49 48 56 57 65 66 58 59 51 52 53 45 37 36 35 27 19 20 21 22 23 31 30 38 46 47 55 63 62 70 69 68 
1 1 0 1 1 1 1 1 
1 1 1 1 0 0 2 1 
1 1 0 1 1 1 1 1 
1 1 0 1 0 0 1 1 
1 1 1 1 1 1 1 0 
0 0 1 0 0 1 1 1 
1 1 1 1 1 1 0 1 
1 1 1 1 0 0 1 1 
0 1 1 0 1 1 1 0 

Complexity: 3
Time:  2 seconds or 0.03 minutes or 0 hours