10 8
30
30 29 28 20 12 4 5 6 7 15 14 22 23 31 39 47 55 54 62 70 69 68 67 59 60 52 44 45 37 36 35 43 51 50 49 41 33 34 26 18 10 11 3 2 1 9 8 16 24 32 40 48 56 57 65 73 74 75 76 77 78 79 
0 1 1 1 1 1 1 1 
1 1 1 1 1 0 1 1 
1 0 1 0 1 0 1 1 
1 0 1 0 1 1 2 1 
1 1 1 1 1 1 0 1 
1 1 0 1 1 1 0 1 
1 1 1 1 1 0 1 1 
1 1 0 1 1 0 1 0 
0 1 0 1 1 1 1 0 
0 1 1 1 1 1 1 1 

Complexity: 4
Time: 2402 seconds or 40.03 minutes or 0.67 hours