11 8
17
17 18 26 34 35 43 42 41 40 32 24 16 8 0 1 2 3 11 12 20 28 29 21 13 5 6 14 15 23 31 39 38 37 45 53 52 51 50 58 66 65 57 56 64 72 73 81 82 83 75 76 68 60 61 62 54 55 63 71 79 78 77 85 
1 1 1 1 0 1 1 0 
1 0 0 1 1 1 1 1 
1 2 1 0 1 1 0 1 
1 0 1 0 1 1 0 1 
1 0 1 1 0 1 1 1 
1 1 1 1 0 1 0 0 
0 0 1 1 1 1 1 1 
1 1 1 0 1 1 1 1 
1 1 1 0 1 0 0 1 
1 1 0 1 1 1 1 1 
0 1 1 1 0 1 0 0 

Complexity: 4
Time: 1520 seconds or 25.33 minutes or 0.42 hours