11 8
19
19 18 26 34 33 32 24 16 8 9 10 2 3 4 12 13 5 6 7 15 14 22 30 29 28 36 37 38 39 47 46 45 53 61 62 63 71 79 87 86 78 77 85 84 83 75 76 68 60 59 51 43 42 50 49 48 56 64 65 66 74 73 81 
0 0 1 1 1 1 1 1 
1 1 1 0 1 1 1 1 
1 0 1 2 0 0 1 0 
1 0 1 0 1 1 1 0 
1 1 1 0 1 1 1 1 
0 0 1 1 0 1 1 1 
1 1 1 1 0 1 0 0 
1 0 0 1 1 1 1 1 
1 1 1 0 1 0 0 1 
0 1 1 1 1 1 1 1 
0 1 0 1 1 1 1 1 

Complexity: 4
Time: 106 seconds or 1.77 minutes or 0.03 hours