11 8
51
51 52 53 61 62 54 55 63 71 79 87 86 78 77 76 68 67 75 83 82 81 80 72 73 65 66 58 57 49 48 40 41 42 34 33 32 24 16 8 9 1 2 10 18 26 27 28 36 44 45 46 38 30 31 23 22 21 13 12 11 3 4 5 6 7 
0 1 1 1 1 1 1 1 
1 1 1 1 1 1 0 0 
1 0 1 0 0 1 1 1 
1 0 1 1 1 0 1 1 
1 1 1 0 1 0 1 0 
1 1 1 0 1 1 1 0 
1 1 0 2 1 1 1 1 
0 1 1 0 0 1 1 1 
0 1 1 1 1 0 0 1 
1 1 0 1 1 1 1 1 
1 1 1 1 0 0 1 1 

Complexity: 4
Time: 151 seconds or 2.51 minutes or 0.04 hours