9 9
72
72 63 64 73 74 75 76 77 78 79 80 71 70 61 52 51 60 59 68 67 66 65 56 55 46 45 36 37 38 29 30 39 48 49 40 41 32 33 34 43 44 35 26 25 16 7 6 5 14 23 22 13 12 3 2 11 10 19 18 9 0 
1 0 1 1 0 1 1 1 0 
1 1 1 1 1 1 0 1 0 
1 1 0 0 1 1 0 1 1 
0 0 1 1 0 1 1 1 1 
1 1 1 1 1 1 0 1 1 
1 1 0 1 1 0 1 1 0 
0 1 1 0 0 1 1 1 0 
1 1 1 1 1 1 0 1 1 
2 1 1 1 1 1 1 1 1 

Complexity: 4
Time: 130 seconds or 2.16 minutes or 0.04 hours