9 9
55
55 56 47 38 39 30 31 22 21 12 11 10 1 0 9 18 19 28 37 36 45 54 63 64 73 74 65 66 67 58 49 50 41 42 43 34 25 24 23 14 13 4 5 6 7 8 17 26 35 44 53 62 71 80 79 70 61 60 69 68 77 
1 1 0 0 1 1 1 1 1 
1 1 1 1 1 1 0 0 1 
1 1 0 1 1 1 1 1 1 
0 1 0 1 1 0 0 1 1 
1 1 1 1 0 1 1 1 1 
1 0 1 0 1 1 0 0 1 
1 2 1 0 1 0 1 1 1 
1 1 1 1 1 1 1 1 1 
0 1 1 0 0 1 0 1 1 

Complexity: 4
Time: 128 seconds or 2.13 minutes or 0.04 hours