8 10
52
52 53 43 33 34 24 14 15 5 4 3 2 1 0 10 11 12 22 21 31 41 40 50 60 61 71 72 73 74 64 65 66 76 77 78 68 69 59 49 39 29 28 38 37 47 57 56 55 45 35 25 26 16 17 7 8 9 
1 1 1 1 1 1 0 1 1 1 
1 1 1 0 1 1 1 1 0 0 
0 1 1 0 1 1 1 0 1 1 
0 1 0 1 1 1 0 1 1 1 
1 1 0 1 0 1 0 1 0 1 
1 0 2 1 0 1 1 1 0 1 
1 1 0 0 1 1 1 0 1 1 
0 1 1 1 1 0 1 1 1 0 

Complexity: 4
Time: 591 seconds or 9.85 minutes or 0.16 hours