10 8
66
66 58 59 51 52 53 45 37 38 39 47 46 54 62 63 71 79 78 77 69 68 76 75 74 73 72 64 56 48 49 50 42 43 35 27 26 34 33 32 24 16 17 9 10 11 12 20 28 29 21 22 23 15 7 6 5 4 3 2 1 0 
1 1 1 1 1 1 1 1 
0 1 1 1 1 0 0 1 
1 1 0 0 1 1 1 1 
1 0 1 1 1 1 0 0 
1 1 1 1 0 1 1 1 
0 0 1 1 0 1 1 1 
1 1 1 1 1 1 1 0 
1 0 1 1 0 0 1 1 
1 0 2 0 1 1 0 1 
1 1 1 1 1 1 1 1 

Complexity: 4
Time: 278 seconds or 4.63 minutes or 0.08 hours