9 10
36
36 37 47 48 38 39 29 19 18 17 7 6 16 26 25 24 14 4 3 2 1 0 10 11 12 22 21 31 32 33 43 42 41 40 50 51 61 60 70 80 81 71 72 73 63 53 54 44 45 55 56 66 67 68 58 59 69 79 78 88 87 86 76 75 74 84 
1 1 1 1 1 0 1 1 0 0 
1 1 1 0 1 0 1 1 1 1 
0 1 1 0 1 1 1 0 0 1 
0 1 1 1 0 0 2 1 1 1 
1 1 1 1 1 1 0 1 1 0 
1 1 0 1 1 1 1 0 1 1 
1 1 0 1 0 0 1 1 1 1 
1 1 1 1 1 1 1 0 1 1 
1 1 0 0 1 0 1 1 1 0 

Complexity: 4
Time: 1374 seconds or 22.9 minutes or 0.38 hours