10 9
61
61 70 71 80 79 88 87 78 69 68 67 58 57 56 47 38 39 40 31 32 41 50 51 42 43 52 53 44 35 26 17 8 7 16 25 24 15 14 5 4 13 12 21 20 11 10 1 0 9 18 19 28 27 36 45 54 55 64 63 72 81 82 83 74 75 76 85 
1 1 0 0 1 1 0 1 1 
1 1 1 1 1 1 1 1 1 
1 1 1 1 0 0 1 1 1 
1 1 0 0 1 1 0 0 1 
1 0 1 1 1 1 1 1 1 
1 0 1 0 0 1 1 1 1 
1 1 1 1 1 0 0 2 0 
1 1 0 0 1 1 1 1 1 
1 0 1 1 1 0 1 1 1 
1 1 1 0 1 0 1 1 0 

Complexity: 4
Time: 181 seconds or 3.02 minutes or 0.05 hours