9 10
18
18 28 27 17 16 6 5 4 14 15 25 35 36 46 56 55 45 44 43 33 23 13 12 11 1 0 10 20 21 31 41 42 52 51 50 60 70 80 81 71 72 73 63 64 65 75 74 84 85 86 87 77 78 79 69 68 67 57 58 48 38 39 29 19 9 
1 1 0 0 1 1 1 0 0 1 
1 1 1 1 1 1 1 1 2 1 
1 1 0 1 0 1 0 1 1 1 
0 1 0 1 0 1 1 0 1 1 
0 1 1 1 1 1 1 0 1 0 
1 1 1 0 0 1 1 1 1 0 
1 0 0 1 1 1 0 1 1 1 
1 1 1 1 1 1 0 1 1 1 
1 1 0 0 1 1 1 1 0 0 

Complexity: 4
Time: 1938 seconds or 32.29 minutes or 0.54 hours