9 10
15
15 14 4 5 6 7 17 16 26 36 46 45 55 54 53 43 33 34 24 23 22 12 2 1 0 10 20 30 31 41 40 50 51 52 62 72 71 70 80 81 82 83 73 74 75 65 66 76 86 87 88 89 79 78 68 69 59 58 57 47 48 38 28 29 19 9 
1 1 1 0 1 1 1 1 0 1 
1 0 1 0 1 2 1 1 0 1 
1 0 1 1 1 0 1 0 1 1 
1 1 0 1 1 0 1 0 1 0 
1 1 0 1 0 1 1 1 1 0 
1 1 1 1 1 1 0 1 1 1 
0 0 1 0 0 1 1 0 1 1 
1 1 1 1 1 1 1 0 1 1 
1 1 1 1 0 0 1 1 1 1 

Complexity: 4
Time: 14 seconds or 0.23 minutes or 0 hours