10 9
11
11 12 3 2 1 10 9 18 27 36 37 28 29 30 21 22 23 32 31 40 49 48 47 46 55 54 63 72 81 82 83 84 75 74 65 66 67 58 59 60 69 78 77 86 87 88 79 80 71 62 53 52 51 42 33 34 35 26 17 8 7 16 15 14 5 
0 1 1 1 0 1 0 1 1 
1 1 2 1 0 1 1 1 1 
1 0 0 1 1 1 0 0 1 
1 1 1 1 1 1 1 1 1 
1 1 0 0 1 0 1 0 0 
0 1 1 1 1 0 1 1 1 
1 1 0 0 1 1 1 0 1 
1 0 1 1 1 0 1 0 1 
1 0 1 1 0 1 1 1 1 
1 1 1 1 0 1 1 1 0 

Complexity: 4
Time: 359 seconds or 5.99 minutes or 0.1 hours