9 9
46
46 47 56 57 66 67 76 75 74 73 64 63 54 45 36 27 18 19 28 29 30 39 48 49 50 59 60 69 78 79 70 71 62 53 52 43 42 41 32 33 34 35 26 17 16 7 6 15 14 23 22 13 4 3 12 11 10 1 
0 1 0 1 1 0 1 1 0 
0 1 1 1 1 1 1 1 1 
1 1 0 0 1 1 0 0 1 
1 1 1 1 0 1 1 1 1 
1 0 0 1 0 1 1 1 0 
1 2 1 1 1 1 0 1 1 
1 0 1 1 0 1 1 0 1 
1 1 0 1 1 0 1 1 1 
0 1 1 1 1 0 1 1 0 

Complexity: 4
Time: 234 seconds or 3.89 minutes or 0.06 hours