8 10
57
57 47 46 56 55 54 44 45 35 25 24 14 4 5 6 16 26 27 17 7 8 9 19 29 39 38 48 58 59 69 79 78 77 67 66 76 75 74 73 63 53 52 62 72 71 70 60 50 51 41 40 30 20 21 11 1 2 3 13 12 22 32 33 
0 1 1 1 1 1 1 1 1 1 
0 1 1 1 1 0 1 1 0 1 
1 1 1 0 1 1 1 1 0 1 
1 0 1 1 0 1 0 0 1 1 
1 1 0 0 1 1 1 1 1 0 
1 1 1 1 1 1 1 2 1 1 
1 0 1 1 0 0 1 1 0 1 
1 1 1 1 1 1 1 1 1 1 

Complexity: 4
Time:  0 seconds or 0 minutes or 0 hours