9 9
3
3 4 5 6 7 16 17 26 35 34 33 24 23 22 13 12 11 2 1 0 9 18 19 28 29 30 39 40 41 42 51 50 59 60 61 52 53 62 71 70 69 78 77 76 67 66 65 74 73 64 63 54 55 56 57 48 47 46 37 36 
1 1 1 2 1 1 1 1 0 
1 0 1 1 1 0 0 1 1 
1 1 0 0 1 1 1 0 1 
0 1 1 1 0 0 1 1 1 
1 1 0 1 1 1 1 0 0 
0 1 1 1 0 1 1 1 1 
1 1 1 1 0 1 1 1 1 
1 1 1 1 1 0 1 1 1 
0 1 1 0 1 1 1 0 0 

Complexity: 4
Time: 164 seconds or 2.73 minutes or 0.05 hours