10 8
40
40 32 24 16 8 0 1 9 10 18 19 27 26 34 33 41 49 48 56 64 72 73 74 75 76 68 67 66 58 50 42 43 35 36 28 29 30 22 14 13 12 11 3 4 5 6 7 15 23 31 39 47 46 45 53 52 60 61 62 63 71 70 78 
1 1 0 1 1 1 1 1 
1 1 1 1 1 1 1 1 
1 0 1 1 0 0 1 1 
1 0 1 1 1 1 1 1 
1 1 1 1 1 0 0 1 
2 1 1 1 0 1 1 1 
1 1 1 0 1 1 0 0 
1 0 1 0 1 1 1 1 
1 0 1 1 1 0 1 1 
1 1 1 1 1 0 1 0 

Complexity: 4
Time: 1026 seconds or 17.1 minutes or 0.29 hours