9 10
71
71 61 60 70 80 81 82 72 62 52 53 63 64 74 84 85 75 76 86 87 88 89 79 78 68 67 57 56 55 45 44 43 33 32 31 41 40 30 20 21 11 1 2 3 4 14 13 23 24 25 15 16 26 36 37 27 17 7 8 9 19 29 39 38 48 58 59 
0 1 1 1 1 0 0 1 1 1 
0 1 0 1 1 1 1 1 0 1 
1 1 0 1 1 1 1 1 0 1 
1 1 1 1 0 0 1 1 1 1 
1 1 0 1 1 1 0 0 1 0 
0 0 1 1 0 1 1 1 1 1 
1 1 1 1 1 0 0 1 1 0 
1 2 1 0 1 1 1 0 1 1 
1 1 1 0 1 1 1 1 1 1 

Complexity: 4
Time: 1376 seconds or 22.93 minutes or 0.38 hours