8 10
60
60 70 71 72 62 63 53 54 44 34 35 45 46 47 57 58 68 67 66 65 64 74 75 76 77 78 79 69 59 49 48 38 39 29 19 9 8 18 17 27 26 16 6 5 4 14 24 23 22 32 31 41 42 52 51 50 40 30 20 10 11 12 2 
0 0 1 0 1 1 1 0 1 1 
1 1 1 0 1 0 1 1 1 1 
1 0 1 1 1 0 1 1 0 1 
1 1 1 0 1 1 0 0 1 1 
1 1 1 0 1 1 1 1 1 1 
1 1 1 1 1 0 0 1 1 1 
2 0 1 1 1 1 1 1 1 1 
1 1 1 0 1 1 1 1 1 1 

Complexity: 4
Time: 1435 seconds or 23.92 minutes or 0.4 hours