8 10
57
57 56 66 65 64 63 53 52 51 41 31 32 33 23 24 34 44 45 46 36 26 27 17 7 6 16 15 5 4 3 2 12 11 1 0 10 20 30 40 50 60 61 71 72 73 74 75 76 77 78 79 69 59 58 48 38 28 29 19 9 
1 1 1 1 1 1 1 1 0 1 
1 1 1 0 0 1 1 1 0 1 
1 0 0 1 1 0 1 1 1 1 
1 1 1 1 1 0 1 0 1 0 
1 1 0 0 1 1 1 0 1 0 
1 1 1 1 0 0 1 2 1 1 
1 1 0 1 1 1 1 0 0 1 
0 1 1 1 1 1 1 1 1 1 

Complexity: 4
Time:  7 seconds or 0.12 minutes or 0 hours