9 8
41
41 42 50 51 43 35 36 28 27 26 18 10 2 3 11 12 4 5 6 7 15 14 22 21 29 30 31 39 38 46 45 53 54 55 63 62 70 69 61 60 68 67 66 65 57 49 48 40 32 24 25 17 16 8 0 
1 0 1 1 1 1 1 1 
1 0 1 1 1 0 1 1 
1 1 1 0 0 1 1 0 
1 1 1 1 1 1 1 1 
1 0 0 1 1 0 1 1 
1 2 1 1 0 1 1 0 
1 1 1 1 0 1 1 1 
0 1 0 0 1 1 1 1 
0 1 1 1 1 1 1 0 

Complexity: 3
Time:  0 seconds or 0.01 minutes or 0 hours