10 8
49
49 57 56 64 72 73 74 66 67 59 51 43 42 34 35 27 19 20 28 29 30 38 46 45 44 52 60 68 69 77 78 79 71 63 62 54 55 47 39 31 23 15 7 6 14 13 5 4 3 2 10 9 8 16 17 25 24 32 40 
0 0 1 1 1 1 1 1 
1 1 1 0 0 1 1 1 
1 1 0 1 1 0 0 1 
1 1 0 1 1 1 1 1 
1 0 1 1 0 0 1 1 
1 0 1 1 1 1 1 1 
0 2 0 1 1 0 1 1 
1 1 0 1 1 0 1 1 
1 0 1 1 1 1 0 1 
1 1 1 0 0 1 1 1 

Complexity: 4
Time: 425 seconds or 7.08 minutes or 0.12 hours