9 10
76
76 75 85 86 87 88 89 79 69 68 67 57 56 55 45 35 34 24 25 26 27 37 47 48 49 39 29 28 18 8 7 6 5 15 14 13 12 2 1 11 10 20 21 22 32 42 43 53 63 64 74 73 72 82 81 80 70 60 61 51 41 40 
0 1 1 0 0 1 1 1 1 0 
1 1 1 1 1 1 0 0 1 0 
1 1 1 0 1 1 1 1 1 1 
0 0 1 0 1 1 0 1 0 1 
1 1 1 1 0 1 0 1 1 1 
0 1 0 1 0 1 1 1 0 0 
1 1 0 1 1 0 0 1 1 1 
1 0 1 1 1 1 2 0 0 1 
1 1 1 0 0 1 1 1 1 1 

Complexity: 4
Time: 290 seconds or 4.83 minutes or 0.08 hours