11 8
64
64 65 57 49 50 42 41 40 32 24 16 8 0 1 9 17 18 26 34 35 36 28 29 21 20 12 11 3 4 5 13 14 15 23 31 39 38 46 45 44 52 60 59 67 68 69 61 53 54 55 63 71 79 78 86 85 84 83 75 74 82 81 80 
1 1 0 1 1 1 0 0 
1 1 0 1 1 1 1 1 
1 1 1 0 1 1 0 1 
1 0 1 0 1 1 0 1 
1 0 1 1 1 0 1 1 
1 1 1 0 1 1 1 0 
0 1 1 0 1 1 1 1 
0 1 0 1 1 1 0 1 
2 1 0 1 1 1 0 1 
0 0 1 1 0 0 1 1 
1 1 1 1 1 1 1 0 

Complexity: 4
Time: 1379 seconds or 22.99 minutes or 0.38 hours