11 8
42
42 50 51 43 35 27 28 29 30 22 23 15 14 13 5 4 12 11 19 18 10 9 1 0 8 16 17 25 33 41 40 48 56 57 65 64 72 80 81 82 74 66 67 68 60 52 53 45 37 38 46 47 55 63 62 70 78 77 76 84 85 86 87 
1 1 0 0 1 1 0 0 
1 1 1 1 1 1 1 1 
1 1 1 1 0 0 1 1 
0 1 0 1 1 1 1 0 
0 1 0 1 0 1 1 0 
1 1 2 1 0 1 1 1 
1 0 1 1 1 1 0 1 
1 1 0 0 1 0 1 1 
1 1 1 1 1 0 1 0 
1 0 1 0 1 1 1 0 
1 1 1 0 1 1 1 1 

Complexity: 4
Time: 455 seconds or 7.58 minutes or 0.13 hours