9 10
67
67 68 58 57 56 46 47 48 49 39 38 28 18 19 9 8 7 17 16 26 36 35 45 44 43 53 52 42 32 22 23 24 14 15 5 4 3 2 1 0 10 11 21 31 41 40 50 60 61 71 81 82 72 73 74 64 65 75 85 86 87 77 78 79 
1 1 1 1 1 1 0 1 1 1 
1 1 0 0 1 1 1 1 1 1 
0 1 1 1 1 0 1 0 1 0 
0 1 1 0 0 1 1 0 1 1 
1 1 1 1 1 1 1 1 1 1 
1 0 1 1 0 0 1 1 1 0 
1 1 0 0 1 1 0 2 1 0 
0 1 1 1 1 1 0 1 1 1 
0 1 1 0 0 1 1 1 0 0 

Complexity: 4
Time: 1850 seconds or 30.83 minutes or 0.51 hours