9 9
73
73 72 63 54 55 64 65 66 75 76 77 78 69 70 79 80 71 62 53 52 61 60 59 58 49 48 47 46 37 38 39 30 21 22 23 32 41 42 33 34 35 26 17 8 7 16 15 6 5 4 13 12 11 2 1 0 9 10 19 28 27 
1 1 1 0 1 1 1 1 1 
1 1 1 1 1 0 1 1 1 
0 1 0 1 1 1 0 0 1 
1 1 0 1 0 1 1 1 1 
0 1 1 1 0 1 1 0 0 
0 1 1 1 1 0 0 1 1 
1 1 0 0 1 1 1 1 1 
1 1 1 1 0 0 1 1 1 
1 2 0 1 1 1 1 1 1 

Complexity: 4
Time: 683 seconds or 11.39 minutes or 0.19 hours