11 8
11
11 12 20 21 13 5 6 7 15 23 22 30 29 37 38 46 47 55 54 53 61 60 52 44 43 35 27 26 18 10 2 1 9 8 16 24 32 33 41 40 48 49 50 58 57 65 64 72 80 81 73 74 75 67 68 76 84 85 86 78 70 71 
0 1 1 0 0 1 1 1 
1 1 1 2 1 1 0 1 
1 0 1 0 1 1 1 1 
1 0 1 1 0 1 1 0 
1 1 0 1 0 1 1 0 
1 1 0 1 1 0 1 1 
1 1 1 0 1 1 1 1 
0 1 1 0 1 1 0 0 
1 1 0 1 1 0 1 1 
1 1 1 1 1 0 1 0 
1 1 0 0 1 1 1 0 

Complexity: 4
Time: 422 seconds or 7.03 minutes or 0.12 hours