9 10
54
54 44 43 42 32 22 12 13 3 2 1 11 10 20 30 40 41 51 50 60 70 80 81 71 72 62 63 73 83 84 85 75 65 66 67 77 87 88 89 79 69 59 58 57 47 46 45 35 34 24 25 15 5 6 16 26 27 28 38 39 29 19 18 8 
0 1 1 1 0 1 1 0 1 0 
1 1 1 1 0 1 1 0 1 1 
1 0 1 0 1 1 1 1 1 1 
1 0 1 0 1 1 0 0 1 1 
1 1 1 1 1 1 1 1 0 0 
1 1 0 0 2 0 0 1 1 1 
1 0 1 1 0 1 1 1 0 1 
1 1 1 1 0 1 0 1 0 1 
1 1 0 1 1 1 0 1 1 1 

Complexity: 4
Time: 583 seconds or 9.71 minutes or 0.16 hours