9 10
61
61 51 50 60 70 71 72 82 83 84 74 75 76 66 67 77 87 88 78 79 69 59 58 48 49 39 38 37 47 46 45 55 54 64 63 53 52 42 41 31 21 20 10 0 1 11 12 13 23 33 34 24 14 4 5 15 25 26 27 17 7 8 18 19 
1 1 0 0 1 1 0 1 1 0 
1 1 1 1 1 1 0 1 1 1 
1 1 0 1 1 1 1 1 0 0 
0 1 0 1 1 0 0 1 1 1 
0 1 1 0 0 1 1 1 1 1 
1 1 1 1 1 1 0 0 1 1 
1 2 0 1 1 0 1 1 0 1 
1 1 1 0 1 1 1 1 1 1 
0 0 1 1 1 0 0 1 1 0 

Complexity: 4
Time: 422 seconds or 7.03 minutes or 0.12 hours