9 10
64
64 54 53 52 42 43 33 23 24 25 35 45 46 56 57 67 66 76 75 85 86 87 88 78 79 69 59 49 48 38 37 27 28 29 19 18 8 7 17 16 15 5 4 3 13 12 11 1 0 10 20 21 31 30 40 50 60 61 62 72 73 83 82 81 80 
1 1 0 1 1 1 0 1 1 0 
1 1 1 1 0 1 1 1 1 1 
1 1 0 1 1 1 0 1 1 1 
1 1 0 1 0 1 0 1 1 0 
1 0 1 1 0 1 1 0 1 1 
1 0 1 1 1 0 1 1 0 1 
1 1 1 0 2 0 1 1 0 1 
0 0 1 1 0 1 1 0 1 1 
1 1 1 1 0 1 1 1 1 0 

Complexity: 4
Time: 248 seconds or 4.14 minutes or 0.07 hours