9 8
44
44 45 46 54 55 47 39 38 30 29 28 20 21 22 23 15 14 6 5 4 3 11 10 2 1 0 8 9 17 16 24 25 26 27 35 34 42 41 40 48 56 64 65 57 58 50 51 59 67 68 60 61 62 70 71 
1 1 1 1 1 1 1 0 
1 1 1 1 0 0 1 1 
1 1 0 0 1 1 1 1 
1 1 1 1 1 1 1 0 
0 0 1 1 0 0 1 1 
1 1 1 0 2 1 1 1 
1 0 1 1 0 0 1 1 
1 1 1 1 1 1 1 0 
1 1 0 1 1 0 1 1 

Complexity: 3
Time: 158 seconds or 2.64 minutes or 0.04 hours