8 10
70
70 60 50 40 41 31 32 33 43 53 52 62 61 71 72 73 74 64 54 55 45 35 36 37 47 46 56 66 76 77 78 68 58 59 49 39 29 28 18 19 9 8 7 6 5 15 16 26 25 24 14 13 3 2 12 22 21 20 10 0 
1 0 1 1 0 1 1 1 1 1 
1 0 1 1 1 1 1 0 1 1 
1 1 1 0 1 1 1 0 1 1 
0 1 1 1 0 1 1 1 0 1 
1 1 0 1 0 1 1 1 0 1 
1 0 1 1 1 1 1 0 1 1 
1 1 1 0 1 0 1 0 1 0 
2 1 1 1 1 0 1 1 1 0 

Complexity: 4
Time: 80 seconds or 1.33 minutes or 0.02 hours