11 8
8
8 0 1 9 10 18 17 16 24 32 40 41 33 34 42 50 51 43 44 52 60 59 67 66 65 57 56 64 72 80 81 82 83 75 76 77 69 70 78 86 87 79 71 63 62 54 46 45 37 38 39 31 30 29 21 20 28 27 19 11 12 4 5 6 14 15 
1 1 0 0 1 1 1 0 
2 1 1 1 1 0 1 1 
1 1 1 1 1 1 0 0 
1 0 0 1 1 1 1 1 
1 1 1 0 0 1 1 1 
1 1 1 1 1 1 1 0 
0 0 1 1 1 0 1 0 
1 1 0 1 1 0 1 1 
1 1 1 1 0 1 1 1 
1 0 0 1 1 1 1 1 
1 1 1 1 0 0 1 1 

Complexity: 4
Time: 2143 seconds or 35.72 minutes or 0.6 hours