8 10
57
57 47 46 45 35 36 26 25 24 34 33 32 42 52 53 54 64 63 73 74 75 65 66 76 77 78 79 69 59 58 48 49 39 29 19 18 28 27 17 7 6 5 4 14 13 12 11 1 0 10 20 21 31 30 40 50 60 61 71 
1 1 0 0 1 1 1 1 0 0 
1 1 1 1 1 0 0 1 1 1 
1 1 0 0 1 1 1 1 1 1 
1 1 1 1 1 1 1 0 0 1 
1 0 1 0 0 1 1 1 1 1 
1 0 1 1 1 0 0 2 1 1 
1 1 0 1 1 1 1 0 0 1 
0 1 0 1 1 1 1 1 1 1 

Complexity: 4
Time: 49 seconds or 0.82 minutes or 0.01 hours