9 10
5
5 6 7 17 18 8 9 19 29 28 38 39 49 48 47 57 58 59 69 68 78 79 89 88 87 86 85 75 76 66 65 64 54 55 45 35 36 26 25 24 14 13 23 33 43 53 52 62 72 73 83 82 81 71 70 60 50 51 41 31 30 20 21 22 12 2 1 0 
1 1 1 0 0 2 1 1 1 1 
0 0 1 1 1 0 0 1 1 1 
1 1 1 1 1 1 1 0 1 1 
1 1 0 1 0 1 1 0 1 1 
0 1 0 1 0 1 0 1 1 1 
1 1 1 1 1 1 0 1 1 1 
1 0 1 0 1 1 1 0 1 1 
1 1 1 1 0 1 1 0 1 1 
0 1 1 1 0 1 1 1 1 1 

Complexity: 4
Time: 1993 seconds or 33.21 minutes or 0.55 hours