10 9
76
76 67 66 65 74 83 84 85 86 87 78 69 70 79 80 71 62 53 52 51 50 59 58 49 48 47 38 29 30 31 22 23 32 41 42 43 34 25 26 17 8 7 6 15 14 5 4 13 12 11 2 1 10 9 18 19 28 27 36 45 54 55 64 63 72 81 
0 1 1 0 1 1 1 1 1 
1 1 1 1 1 1 1 0 1 
1 1 0 0 1 1 0 1 1 
1 1 1 1 1 1 0 1 0 
1 0 1 0 0 1 1 1 0 
1 0 1 1 1 1 1 1 1 
1 1 0 0 1 1 0 0 1 
1 1 1 1 1 0 1 1 1 
1 0 1 0 2 0 1 1 1 
1 0 1 1 1 1 1 0 0 

Complexity: 4
Time: 904 seconds or 15.07 minutes or 0.25 hours