10 9
24
24 15 6 5 14 13 12 21 20 11 2 1 0 9 10 19 28 29 38 37 36 45 46 55 64 73 72 81 82 83 74 65 66 57 48 49 40 31 32 41 50 51 60 59 68 77 76 85 86 87 88 89 80 79 70 61 62 53 44 43 34 25 26 17 8 
1 1 1 0 0 1 1 0 1 
1 1 1 1 1 1 1 0 1 
0 1 1 1 0 0 2 1 1 
0 1 1 0 1 1 0 1 0 
1 1 1 0 1 1 0 1 1 
1 1 0 1 1 1 1 0 1 
0 1 0 1 0 1 1 1 1 
0 1 1 1 0 1 0 1 0 
1 1 1 0 1 1 0 1 1 
1 1 1 0 1 1 1 1 1 

Complexity: 4
Time: 205 seconds or 3.42 minutes or 0.06 hours