8 10
66
66 56 55 54 44 43 42 41 51 50 40 30 31 21 11 10 0 1 2 12 13 23 33 34 35 36 26 16 15 14 4 5 6 7 17 18 8 9 19 29 39 38 37 47 48 49 59 69 68 67 77 76 75 74 73 63 62 61 71 70 
1 1 1 0 1 1 1 1 1 1 
1 1 1 1 1 1 1 1 1 1 
0 1 0 1 0 0 1 0 0 1 
1 1 0 1 1 1 1 1 1 1 
1 1 1 1 1 0 0 1 1 1 
1 1 0 0 1 1 1 0 0 1 
0 1 1 1 0 0 2 1 1 1 
1 1 0 1 1 1 1 1 0 0 

Complexity: 4
Time: 16 seconds or 0.27 minutes or 0 hours