9 10
7
7 17 18 19 29 39 38 37 36 26 25 35 45 44 43 53 63 64 65 66 56 57 58 48 49 59 69 68 78 79 89 88 87 86 76 75 74 73 83 82 72 71 70 60 50 40 41 51 52 42 32 33 23 13 14 15 5 4 3 2 12 11 21 20 10 0 
1 0 1 1 1 1 0 2 0 0 
1 1 1 1 1 1 0 1 1 1 
1 1 0 1 0 1 1 0 0 1 
0 0 1 1 0 1 1 1 1 1 
1 1 1 1 1 1 0 0 1 1 
1 1 1 1 0 0 1 1 1 1 
1 0 0 1 1 1 1 0 1 1 
1 1 1 1 1 1 1 0 1 1 
0 0 1 1 0 0 1 1 1 1 

Complexity: 4
Time: 1160 seconds or 19.33 minutes or 0.32 hours