11 8
15
15 23 31 30 22 14 13 5 4 12 11 10 2 1 0 8 16 17 25 24 32 40 48 56 64 72 80 81 73 65 66 67 75 83 84 76 77 85 86 87 79 78 70 62 61 60 59 51 50 49 41 33 34 35 27 19 20 28 36 44 45 37 38 46 54 55 
1 1 1 0 1 1 0 0 
1 0 1 1 1 1 1 2 
1 1 0 1 1 0 1 1 
1 1 0 1 1 0 1 1 
1 1 1 1 1 1 1 0 
1 1 0 0 1 1 1 0 
1 1 1 1 0 0 1 1 
1 0 0 1 1 1 1 0 
1 1 1 1 0 0 1 0 
1 1 0 1 1 1 1 1 
1 1 0 1 1 1 1 1 

Complexity: 4
Time: 235 seconds or 3.91 minutes or 0.07 hours