11 8
36
36 37 38 46 54 55 47 39 31 30 22 21 20 19 27 35 43 44 52 60 61 69 70 71 79 87 86 85 84 76 68 67 75 83 82 81 80 72 73 65 57 58 50 49 48 40 32 33 34 26 25 24 16 8 9 10 2 3 4 12 13 14 15 7 
0 0 1 1 1 0 0 1 
1 1 1 0 1 1 1 1 
1 0 0 1 1 1 1 0 
1 1 1 1 0 0 1 1 
1 1 1 1 2 1 1 1 
1 0 0 1 1 0 1 1 
1 1 1 0 1 0 1 1 
0 1 1 0 1 1 0 0 
0 1 0 1 1 1 1 1 
1 1 0 1 1 0 0 1 
1 1 1 1 1 1 1 1 

Complexity: 4
Time: 2177 seconds or 36.29 minutes or 0.6 hours