11 8
49
49 41 40 32 33 34 26 27 28 29 37 36 44 43 51 59 58 57 65 64 72 73 81 82 74 75 76 68 69 77 85 86 78 70 71 63 62 61 53 54 46 47 39 31 23 15 7 6 14 22 21 20 12 4 3 11 10 9 17 16 8 0 
1 0 0 1 1 0 1 1 
1 1 1 1 1 0 1 1 
1 1 0 0 1 1 1 1 
0 0 1 1 1 1 0 1 
1 1 1 0 1 1 0 1 
1 1 0 1 1 0 1 1 
0 2 0 1 0 1 1 0 
0 1 1 1 0 1 1 1 
1 1 0 0 1 1 1 1 
1 1 1 1 1 1 1 0 
0 1 1 0 0 1 1 0 

Complexity: 4
Time: 3442 seconds or 57.37 minutes or 0.96 hours