10 8
59
59 60 61 53 52 44 45 46 38 39 47 55 63 71 70 78 77 76 75 67 66 74 73 65 64 56 48 49 50 42 34 35 36 28 29 30 22 14 15 7 6 5 4 12 20 19 18 17 25 33 32 24 16 8 9 10 2 
0 0 1 0 1 1 1 1 
1 1 1 0 1 0 1 1 
1 1 1 1 1 0 1 0 
1 1 0 0 1 1 1 0 
1 1 1 1 1 0 1 1 
0 0 1 0 1 1 1 1 
1 1 1 0 1 1 0 1 
1 0 0 2 1 1 0 1 
1 1 1 1 0 0 1 1 
0 1 1 1 1 1 1 0 

Complexity: 4
Time: 709 seconds or 11.82 minutes or 0.2 hours