9 9
26
26 17 16 7 6 5 4 3 2 1 0 9 10 19 18 27 28 29 30 21 12 13 22 23 24 33 34 35 44 43 52 61 60 59 50 41 40 39 38 47 46 45 54 55 64 73 74 65 56 57 58 67 76 77 78 79 70 71 
1 1 1 1 1 1 1 1 0 
1 1 0 1 1 0 0 1 1 
1 1 0 1 1 1 1 0 2 
1 1 1 1 0 0 1 1 1 
0 0 1 1 1 1 0 1 1 
1 1 1 0 0 1 0 1 0 
1 1 1 1 1 1 1 1 0 
0 1 1 0 1 0 0 1 1 
0 1 1 0 1 1 1 1 0 

Complexity: 4
Time: 77 seconds or 1.29 minutes or 0.02 hours