10 8
13
13 14 22 23 15 7 6 5 4 3 2 1 0 8 16 17 18 10 11 19 20 28 29 37 38 39 47 46 45 53 52 51 50 58 66 67 68 60 61 62 63 71 79 78 77 76 75 74 73 72 64 56 48 49 41 42 43 35 34 33 25 24 32 
1 1 1 1 1 1 1 1 
1 0 1 1 0 2 1 1 
1 1 1 1 1 0 1 1 
1 1 0 0 1 1 0 0 
1 1 1 1 0 1 1 1 
0 1 1 1 0 1 1 1 
1 1 1 1 1 1 0 0 
1 0 1 0 1 1 1 1 
1 0 1 1 1 0 0 1 
1 1 1 1 1 1 1 1 

Complexity: 4
Time: 651 seconds or 10.84 minutes or 0.18 hours