8 10
61
61 71 72 62 52 51 50 40 41 31 21 11 10 0 1 2 12 22 23 33 43 53 54 64 74 75 65 66 76 77 78 79 69 59 58 57 47 46 45 35 36 26 25 24 14 4 5 6 7 17 18 28 38 39 29 19 9 
1 1 1 0 1 1 1 1 0 1 
1 1 1 0 1 0 0 1 1 1 
0 1 1 1 1 1 1 0 1 1 
0 1 0 1 0 1 1 0 1 1 
1 1 0 1 0 1 1 1 0 0 
1 1 1 1 1 0 0 1 1 1 
0 2 1 0 1 1 1 0 0 1 
0 1 1 0 1 1 1 1 1 1 

Complexity: 4
Time: 304 seconds or 5.06 minutes or 0.08 hours