9 10
20
20 10 11 1 2 3 4 5 6 7 17 18 8 9 19 29 28 38 39 49 59 69 79 78 68 67 77 87 86 76 75 85 84 83 73 74 64 63 62 52 53 43 33 34 44 45 55 56 57 47 46 36 26 25 15 14 13 12 22 21 31 41 40 50 60 70 71 81 
0 1 1 1 1 1 1 1 1 1 
1 1 1 1 1 1 0 1 1 1 
2 1 1 0 0 1 1 0 1 1 
0 1 0 1 1 0 1 0 1 1 
1 1 0 1 1 1 1 1 0 1 
1 0 1 1 0 1 1 1 0 1 
1 0 1 1 1 0 0 1 1 1 
1 1 0 1 1 1 1 1 1 1 
0 1 0 1 1 1 1 1 0 0 

Complexity: 4
Time: 2771 seconds or 46.19 minutes or 0.77 hours