9 10
7
7 8 18 28 29 39 49 59 69 68 58 57 47 37 36 26 16 6 5 15 14 4 3 13 23 22 12 11 1 0 10 20 30 31 41 40 50 60 70 71 81 82 83 84 85 75 74 64 63 62 52 42 43 44 34 35 45 55 65 66 76 77 78 88 89 
1 1 0 1 1 1 1 2 1 0 
1 1 1 1 1 1 1 0 1 0 
1 0 1 1 0 0 1 0 1 1 
1 1 0 0 1 1 1 1 0 1 
1 1 1 1 1 1 0 1 0 1 
1 0 1 0 0 1 0 1 1 1 
1 0 1 1 1 1 1 0 1 1 
1 1 0 0 1 1 1 1 1 0 
0 1 1 1 1 1 0 0 1 1 

Complexity: 4
Time: 1531 seconds or 25.51 minutes or 0.43 hours