11 8
12
12 20 19 18 26 34 35 36 44 45 46 54 55 47 39 38 30 29 21 22 14 15 7 6 5 4 3 2 1 9 17 16 24 32 33 41 49 48 56 64 65 57 58 50 51 52 60 61 62 70 78 79 87 86 85 84 76 68 67 75 74 73 81 
0 1 1 1 1 1 1 1 
0 1 0 0 2 0 1 1 
1 1 1 1 1 1 1 0 
1 0 1 0 0 1 1 0 
1 1 1 1 1 0 1 1 
0 1 0 0 1 1 1 1 
1 1 1 1 1 0 1 1 
1 1 1 0 1 1 1 0 
1 1 0 1 1 0 1 0 
0 1 1 1 1 0 1 1 
0 1 0 0 1 1 1 1 

Complexity: 4
Time: 83 seconds or 1.38 minutes or 0.02 hours