9 10
28
28 38 37 36 46 45 35 25 15 5 6 16 17 18 8 9 19 29 39 49 48 58 57 67 68 69 79 78 77 87 86 76 66 65 64 54 53 52 42 32 33 34 24 14 13 12 2 1 11 21 20 30 31 41 51 61 60 70 80 81 82 72 73 74 84 
0 1 1 0 0 1 1 0 1 1 
0 1 1 1 1 1 1 1 1 1 
1 1 0 0 1 1 0 0 2 1 
1 1 1 1 1 1 1 1 1 1 
0 1 1 0 0 1 1 0 1 1 
0 1 1 1 1 0 0 1 1 0 
1 1 0 0 1 1 1 1 1 1 
1 0 1 1 1 0 1 1 1 1 
1 1 1 0 1 0 1 1 0 0 

Complexity: 4
Time: 834 seconds or 13.9 minutes or 0.23 hours