9 10
66
66 67 68 78 79 89 88 87 77 76 75 74 84 83 82 72 71 81 80 70 60 50 51 41 31 21 20 10 0 1 11 12 13 3 4 5 15 16 6 7 8 18 19 29 28 27 37 36 35 34 24 23 33 43 42 52 53 63 64 54 55 56 46 47 48 49 59 
1 1 0 1 1 1 1 1 1 0 
1 1 1 1 0 1 1 0 1 1 
1 1 0 1 1 0 0 1 1 1 
0 1 0 1 1 1 1 1 0 0 
0 1 1 1 0 0 1 1 1 1 
1 1 1 1 1 1 1 0 0 1 
1 0 0 1 1 0 2 1 1 0 
1 1 1 0 1 1 1 1 1 1 
1 1 1 1 1 0 0 1 1 1 

Complexity: 4
Time: 2008 seconds or 33.47 minutes or 0.56 hours