10 9
77
77 76 67 66 65 56 47 38 39 48 49 58 59 60 69 70 71 80 89 88 87 86 85 84 83 82 73 64 63 54 45 36 37 28 19 20 21 22 31 32 41 42 43 52 53 44 35 26 17 8 7 16 25 24 15 14 5 4 3 2 11 10 9 0 
1 0 1 1 1 1 0 1 1 
1 1 1 0 0 1 1 1 1 
0 1 1 1 1 0 1 1 1 
0 1 0 0 1 1 0 0 1 
1 1 1 1 0 1 1 1 1 
1 0 1 1 1 0 0 1 1 
1 0 1 0 1 1 1 0 0 
1 1 1 1 1 0 1 1 1 
0 1 0 0 1 2 0 0 1 
0 1 1 1 1 1 1 1 1 

Complexity: 4
Time: 1312 seconds or 21.87 minutes or 0.36 hours