11 8
73
73 74 82 83 75 67 68 76 77 78 86 87 79 71 63 55 47 39 38 46 54 62 61 60 52 44 43 35 36 37 29 30 22 14 15 7 6 5 13 12 20 19 11 10 2 1 0 8 16 17 18 26 34 33 32 40 48 49 50 58 66 65 64 72 80 
1 1 1 0 0 1 1 1 
1 0 1 1 1 1 1 1 
1 1 1 1 1 0 1 0 
0 0 1 0 0 1 1 0 
1 1 1 1 1 1 1 1 
1 0 0 1 1 0 1 1 
1 1 1 0 1 0 1 1 
0 0 1 0 1 1 1 1 
1 1 1 1 1 0 0 1 
1 2 1 1 1 1 1 1 
1 0 1 1 0 0 1 1 

Complexity: 4
Time: 134 seconds or 2.24 minutes or 0.04 hours