8 10
8
8 9 19 29 39 38 37 27 17 7 6 5 4 14 15 25 24 23 33 43 42 52 53 54 55 45 35 36 46 47 48 58 68 69 79 78 77 67 66 65 75 74 73 72 62 61 71 70 60 50 40 30 31 21 20 10 11 12 2 
0 0 1 0 1 1 1 1 2 1 
1 1 1 0 1 1 0 1 0 1 
1 1 0 1 1 1 0 1 0 1 
1 1 0 1 0 1 1 1 1 1 
1 0 1 1 0 1 1 1 1 0 
1 0 1 1 1 1 0 0 1 0 
1 1 1 0 0 1 1 1 1 1 
1 1 1 1 1 1 0 1 1 1 

Complexity: 4
Time: 458 seconds or 7.64 minutes or 0.13 hours