8 10
44
44 54 55 45 35 36 26 25 24 23 33 32 31 41 40 30 20 10 0 1 11 12 13 3 4 5 15 16 17 18 8 9 19 29 28 38 48 47 57 58 59 69 79 78 77 67 66 76 75 74 73 63 53 52 62 61 60 70 
1 1 0 1 1 1 0 0 1 1 
1 1 1 1 0 1 1 1 1 1 
1 0 0 1 1 1 1 0 1 1 
1 1 1 1 0 1 1 0 1 0 
1 1 0 0 2 1 0 1 1 0 
0 0 1 1 1 1 0 1 1 1 
1 1 1 1 0 0 1 1 0 1 
1 0 0 1 1 1 1 1 1 1 

Complexity: 4
Time: 85 seconds or 1.42 minutes or 0.02 hours