11 8
60
60 52 53 54 62 63 71 79 87 86 78 77 69 68 67 75 76 84 83 82 81 73 72 64 65 57 58 50 49 41 40 32 24 16 17 25 33 34 35 43 44 36 28 29 30 38 46 47 39 31 23 22 14 6 5 13 12 11 19 18 10 2 1 0 
1 1 1 0 0 1 1 0 
0 0 1 1 1 1 1 0 
1 1 1 1 0 0 1 1 
1 1 0 0 1 1 1 1 
1 1 1 1 1 0 1 1 
1 1 0 1 1 0 1 1 
0 1 1 0 1 1 1 0 
0 1 1 0 2 0 1 1 
1 1 0 1 1 1 0 1 
1 1 0 1 1 1 1 1 
0 1 1 1 1 0 1 1 

Complexity: 4
Time: 3485 seconds or 58.08 minutes or 0.97 hours