9 10
51
51 61 60 70 71 81 82 72 73 63 53 54 55 45 46 36 35 34 33 43 42 41 40 30 20 10 11 21 22 12 2 3 13 14 15 25 26 27 17 16 6 7 8 18 19 29 39 38 48 49 59 58 57 67 66 76 75 74 84 85 86 87 77 78 79 89 
0 0 1 1 0 0 1 1 1 0 
1 1 1 1 1 1 1 1 1 1 
1 1 1 0 0 1 1 1 0 1 
1 0 0 1 1 1 1 0 1 1 
1 1 1 1 0 1 1 0 1 1 
0 2 0 1 1 1 0 1 1 1 
1 1 0 1 0 0 1 1 0 0 
1 1 1 1 1 1 1 1 1 1 
0 1 1 0 1 1 1 1 0 1 

Complexity: 4
Time: 4377 seconds or 72.95 minutes or 1.22 hours