9 10
29
29 19 18 17 7 6 5 15 14 13 23 22 12 2 1 11 10 20 30 31 41 42 43 53 54 64 65 66 67 57 47 46 45 44 34 24 25 26 27 37 38 48 58 59 69 79 78 88 87 86 85 75 74 84 83 82 81 80 70 71 72 62 61 51 50 
0 1 1 0 0 1 1 1 0 0 
1 1 1 1 1 1 0 1 1 1 
1 0 1 1 1 1 1 1 0 2 
1 1 0 0 1 0 0 1 1 0 
0 1 1 1 1 1 1 1 1 0 
1 1 0 1 1 0 0 1 1 1 
0 1 1 0 1 1 1 1 0 1 
1 1 1 0 1 1 0 0 1 1 
1 1 1 1 1 1 1 1 1 0 

Complexity: 4
Time: 1286 seconds or 21.44 minutes or 0.36 hours