10 8
68
68 69 70 62 63 71 79 78 77 76 75 74 73 65 64 56 48 40 32 33 41 42 50 58 59 51 52 53 45 46 47 39 38 30 31 23 15 7 6 14 22 21 20 28 36 35 27 26 25 17 16 8 0 1 2 10 11 12 4 
1 1 1 0 1 0 1 1 
1 0 1 1 1 0 1 1 
1 1 0 0 1 1 1 1 
0 1 1 1 1 0 1 1 
1 1 0 1 1 0 1 1 
1 1 1 0 0 1 1 1 
1 0 1 1 1 1 0 0 
1 0 1 1 0 0 1 1 
1 1 0 0 2 1 1 1 
0 1 1 1 1 1 1 1 

Complexity: 4
Time: 186 seconds or 3.1 minutes or 0.05 hours