9 9
65
65 66 57 48 39 38 29 20 21 22 31 32 23 14 15 6 5 4 3 2 11 10 1 0 9 18 27 36 37 46 55 54 63 72 73 74 75 76 77 78 69 70 71 62 61 60 59 58 49 50 51 42 43 44 35 34 25 16 17 8 
1 1 1 1 1 1 1 0 1 
1 1 1 0 0 1 1 1 1 
1 0 1 1 1 1 0 1 0 
1 0 1 0 1 1 0 1 1 
1 1 1 1 0 0 1 1 1 
0 1 0 1 1 1 1 0 0 
1 1 0 1 1 1 1 1 1 
1 0 2 1 0 0 1 1 1 
1 1 1 1 1 1 1 0 0 

Complexity: 4
Time: 115 seconds or 1.91 minutes or 0.03 hours