9 9
63
63 72 73 74 65 56 55 54 45 36 37 38 29 20 19 18 9 0 1 2 3 4 13 12 21 22 23 32 33 24 15 6 7 16 17 26 35 44 43 52 53 62 71 70 61 60 59 50 41 40 39 48 57 58 67 76 77 78 
1 1 1 1 1 0 1 1 0 
1 0 0 1 1 0 1 1 1 
1 1 1 1 1 1 1 0 1 
0 0 1 0 0 1 1 0 1 
1 1 1 1 1 1 0 1 1 
1 0 0 1 0 1 0 1 1 
1 1 1 1 1 1 1 1 1 
2 0 1 0 1 0 0 1 1 
1 1 1 0 1 1 1 0 0 

Complexity: 4
Time:  5 seconds or 0.08 minutes or 0 hours