9 8
25
25 24 16 8 0 1 2 10 18 19 20 12 4 5 6 7 15 23 22 21 29 28 27 35 43 42 41 33 32 40 48 56 64 65 57 58 59 51 52 53 45 37 38 39 47 46 54 55 63 71 70 62 61 69 68 
1 1 1 0 1 1 1 1 
1 0 1 0 1 0 0 1 
1 0 1 1 1 1 1 1 
1 2 0 1 1 1 0 0 
1 1 0 1 0 1 1 1 
1 1 1 1 0 1 1 1 
1 0 0 1 1 1 1 1 
1 1 1 1 0 1 1 1 
1 1 0 0 1 1 1 1 

Complexity: 3
Time: 19 seconds or 0.32 minutes or 0.01 hours