9 10
12
12 13 3 4 14 15 16 6 7 8 18 19 29 39 38 28 27 26 25 35 34 33 43 53 54 44 45 46 47 57 58 59 69 79 89 88 87 77 67 66 65 75 85 84 74 73 83 82 81 80 70 71 61 62 52 51 50 40 30 31 32 22 21 11 10 0 
1 0 0 1 1 0 1 1 1 0 
1 1 2 1 1 1 1 0 1 1 
0 1 1 0 0 1 1 1 1 1 
1 1 1 1 1 1 0 0 1 1 
1 0 0 1 1 1 1 1 0 0 
1 1 1 1 1 0 0 1 1 1 
0 1 1 0 0 1 1 1 0 1 
1 1 0 1 1 1 0 1 0 1 
1 1 1 1 1 1 0 1 1 1 

Complexity: 4
Time: 1951 seconds or 32.52 minutes or 0.54 hours