9 10
1
1 11 10 20 30 40 41 31 21 22 12 2 3 4 14 15 16 17 7 8 9 19 18 28 38 37 27 26 25 24 34 33 43 44 45 46 56 57 58 48 49 59 69 79 89 88 78 77 76 66 65 75 85 84 74 64 63 53 52 62 61 60 70 71 72 82 
0 2 1 1 1 0 0 1 1 1 
1 1 1 0 1 1 1 1 1 1 
1 1 1 0 1 1 1 1 1 0 
1 1 0 1 1 0 0 1 1 0 
1 1 0 1 1 1 1 0 1 1 
0 0 1 1 0 0 1 1 1 1 
1 1 1 1 1 1 1 0 0 1 
1 1 1 0 1 1 1 1 1 1 
0 0 1 0 1 1 0 0 1 1 

Complexity: 4
Time: 592 seconds or 9.87 minutes or 0.16 hours