9 10
17
17 27 28 38 37 36 35 45 55 54 64 65 66 67 57 47 48 49 59 69 79 78 88 87 86 85 75 74 73 83 82 81 80 70 60 50 51 61 62 52 42 43 33 32 22 21 31 30 20 10 0 1 2 3 13 14 24 25 15 16 6 7 8 9 19 
1 1 1 1 0 0 1 1 1 1 
1 0 0 1 1 1 1 2 0 1 
1 1 1 0 1 1 0 1 1 0 
1 1 1 1 0 1 1 1 1 0 
0 0 1 1 0 1 0 1 1 1 
1 1 1 0 1 1 0 1 0 1 
1 1 1 0 1 1 1 1 0 1 
1 0 0 1 1 1 0 0 1 1 
1 1 1 1 0 1 1 1 1 0 

Complexity: 4
Time: 1222 seconds or 20.37 minutes or 0.34 hours