10 9
69
69 60 59 50 51 42 43 52 53 62 71 80 79 78 87 86 85 76 67 66 75 84 83 82 81 72 73 64 55 54 45 36 27 28 29 38 47 56 57 48 39 40 31 32 23 22 21 20 11 10 9 0 1 2 3 4 5 14 15 16 25 34 35 26 17 8 
1 1 1 1 1 1 0 0 1 
1 1 1 0 0 1 1 1 1 
0 0 1 1 1 1 0 1 1 
1 1 1 0 1 1 0 1 1 
1 0 1 1 1 0 1 1 0 
1 0 1 1 0 1 1 1 1 
1 1 1 1 0 1 1 0 1 
0 1 0 1 1 0 2 0 1 
1 1 0 1 1 0 1 1 1 
1 1 1 1 1 1 1 0 0 

Complexity: 4
Time: 2292 seconds or 38.2 minutes or 0.64 hours