9 9
79
79 80 71 62 53 44 43 52 61 60 69 78 77 68 67 66 57 56 65 74 73 64 55 54 45 36 27 28 37 38 39 48 49 50 41 40 31 22 21 20 11 10 9 0 1 2 3 4 13 14 23 24 33 34 35 26 17 16 7 6 
1 1 1 1 1 0 1 1 0 
1 1 1 0 1 1 0 1 1 
0 0 1 1 1 1 1 0 1 
1 1 0 0 1 0 1 1 1 
1 1 1 1 1 1 0 1 1 
1 0 0 1 1 1 0 1 1 
1 1 1 1 0 0 1 1 1 
0 1 1 1 1 1 1 0 1 
0 1 1 0 0 1 1 2 1 

Complexity: 4
Time: 116 seconds or 1.93 minutes or 0.03 hours