11 8
53
53 54 55 47 39 38 30 22 21 29 37 36 44 43 42 50 51 59 60 61 69 70 71 79 78 86 85 84 76 75 83 82 74 66 65 73 72 64 56 48 49 41 33 32 24 16 8 0 1 9 10 18 26 27 19 11 12 4 5 13 14 15 
1 1 0 0 1 1 0 0 
1 1 1 1 1 1 1 1 
1 0 1 1 0 1 1 0 
1 0 1 1 0 1 1 0 
1 1 0 0 1 1 1 1 
0 1 1 1 1 0 0 1 
1 1 1 1 0 2 1 1 
1 0 0 1 1 1 0 0 
1 1 1 0 0 1 1 1 
1 1 1 1 1 0 1 1 
0 0 1 1 1 1 1 0 

Complexity: 4
Time: 554 seconds or 9.24 minutes or 0.15 hours