10 8
12
12 13 5 4 3 2 10 9 8 16 17 25 24 32 40 41 49 48 56 64 72 73 74 66 58 59 60 68 67 75 76 77 78 70 62 63 55 54 53 52 44 43 42 34 35 27 19 20 21 29 37 38 46 47 39 31 23 22 14 6 7 
0 0 1 1 1 1 1 1 
1 1 1 0 2 1 1 0 
1 1 0 1 1 1 1 1 
1 1 0 1 0 1 0 1 
1 0 1 1 0 1 1 1 
1 1 1 1 1 0 1 1 
1 1 0 0 1 1 1 1 
1 0 1 1 1 0 1 1 
1 0 1 1 1 0 1 0 
1 1 1 1 1 1 1 0 

Complexity: 4
Time: 85 seconds or 1.42 minutes or 0.02 hours