11 8
19
19 18 26 34 42 43 51 52 53 61 69 68 67 75 83 84 85 86 78 79 71 70 62 54 46 47 39 38 37 36 28 29 30 22 14 15 7 6 5 13 12 11 3 2 1 9 17 16 24 32 40 41 49 57 58 66 65 64 72 73 81 
0 1 1 1 0 1 1 1 
0 1 0 1 1 1 1 1 
1 1 1 2 0 0 1 0 
1 0 1 0 1 1 1 0 
1 0 1 0 1 1 1 1 
1 1 1 1 0 0 1 1 
0 1 0 1 1 1 1 0 
0 1 1 0 0 1 1 0 
1 1 1 1 1 1 1 1 
1 1 0 1 0 0 1 1 
0 1 0 1 1 1 1 0 

Complexity: 4
Time: 30 seconds or 0.49 minutes or 0.01 hours