11 8
87
87 79 71 63 62 70 78 86 85 84 76 68 67 75 83 82 74 73 72 64 65 57 58 50 49 48 40 32 33 34 26 25 17 16 8 0 1 2 10 11 19 20 12 4 5 6 14 22 23 31 30 29 37 36 35 43 44 52 60 61 53 45 46 47 
1 1 1 0 1 1 1 0 
1 0 1 1 1 0 1 0 
1 1 0 1 1 0 1 1 
0 1 1 0 0 1 1 1 
1 1 1 1 1 1 0 0 
1 0 0 1 1 1 1 1 
1 1 1 0 1 1 0 0 
0 1 1 0 1 1 1 1 
1 1 0 1 1 0 1 1 
1 1 1 1 1 0 1 1 
0 0 1 1 1 1 1 2 

Complexity: 4
Time: 1064 seconds or 17.74 minutes or 0.3 hours