9 9
55
55 54 45 46 37 28 19 18 9 10 1 2 11 12 3 4 5 6 7 8 17 16 15 24 23 22 31 30 29 38 39 40 49 50 51 42 33 34 35 44 53 52 61 70 71 80 79 78 69 68 77 76 67 58 57 56 65 74 73 72 
0 1 1 1 1 1 1 1 1 
1 1 1 1 0 0 1 1 1 
1 1 0 0 1 1 1 0 0 
0 1 1 1 1 0 1 1 1 
0 1 1 1 1 0 1 0 1 
1 1 0 0 1 1 1 1 1 
1 2 1 1 1 0 0 1 0 
0 0 1 0 1 1 1 1 1 
1 1 1 0 1 1 1 1 1 

Complexity: 4
Time: 36 seconds or 0.6 minutes or 0.01 hours