9 8
60
60 52 51 50 58 57 56 48 40 41 33 32 24 16 8 0 1 9 17 18 19 11 3 4 5 13 14 15 23 22 21 29 28 27 26 34 35 36 44 45 46 38 39 47 55 63 62 61 69 68 67 66 65 
1 1 0 1 1 1 0 0 
1 1 0 1 0 1 1 1 
1 1 1 1 0 1 1 1 
1 0 1 1 1 1 0 0 
1 1 1 1 1 0 1 1 
1 1 0 0 1 1 1 1 
1 0 1 1 1 0 0 1 
1 1 1 0 2 1 1 1 
0 1 1 1 1 1 0 0 

Complexity: 3
Time: 10 seconds or 0.17 minutes or 0 hours