11 8
82
82 83 75 67 68 69 77 85 86 87 79 71 63 62 61 53 45 46 47 39 38 30 31 23 22 21 13 14 6 5 4 12 11 10 2 1 9 8 16 17 18 26 27 28 36 44 52 51 43 42 41 33 32 40 48 49 57 58 66 65 73 72 
0 1 1 0 1 1 1 0 
1 1 1 1 1 1 1 0 
1 1 1 0 0 1 1 1 
0 0 1 1 1 0 1 1 
1 1 0 0 1 0 1 1 
1 1 1 1 1 1 1 1 
1 1 0 1 1 1 0 0 
0 1 1 0 0 1 1 1 
0 1 1 1 1 1 0 1 
1 1 0 1 0 1 0 1 
0 0 2 1 0 1 1 1 

Complexity: 4
Time: 355 seconds or 5.91 minutes or 0.1 hours