10 8
52
52 60 59 51 50 49 57 56 48 40 32 33 34 26 18 17 16 8 0 1 2 3 11 12 13 5 6 7 15 14 22 30 31 39 38 37 29 21 20 19 27 35 43 44 45 53 54 55 63 71 70 69 77 76 75 67 66 74 73 72 
1 1 1 1 0 1 1 1 
1 0 0 1 1 1 1 1 
1 1 1 1 1 1 1 0 
0 0 1 1 0 1 1 1 
1 1 1 1 0 1 1 1 
1 0 0 1 1 1 0 0 
1 1 1 1 2 1 1 1 
1 1 0 1 1 0 0 1 
0 0 1 1 0 1 1 1 
1 1 1 1 1 1 0 0 

Complexity: 4
Time: 522 seconds or 8.7 minutes or 0.14 hours