11 8
28
28 20 21 22 30 31 23 15 7 6 5 4 12 11 10 2 1 0 8 9 17 25 26 27 35 43 42 41 33 32 40 48 49 57 56 64 65 66 67 59 51 52 53 45 37 38 46 47 55 54 62 70 78 79 87 86 85 77 69 68 76 75 74 82 81 80 
1 1 1 0 1 1 1 1 
1 1 1 1 1 0 0 1 
0 1 0 0 1 1 1 1 
0 1 1 1 2 0 1 1 
1 1 0 1 0 1 1 0 
1 1 1 1 0 1 1 1 
1 1 0 1 1 1 1 1 
1 1 0 1 0 0 1 0 
1 1 1 1 1 1 1 0 
0 0 1 1 1 1 1 1 
1 1 1 0 0 1 1 1 

Complexity: 4
Time: 132 seconds or 2.2 minutes or 0.04 hours