9 10
31
31 41 40 30 20 10 0 1 11 12 22 23 13 3 4 5 15 14 24 34 33 43 53 52 62 61 60 70 71 72 82 83 73 63 64 74 75 76 86 87 77 78 79 69 68 67 57 56 55 45 46 36 26 27 17 7 8 18 19 29 28 38 48 49 
1 1 0 1 1 1 0 1 1 0 
1 1 1 1 1 1 0 1 1 1 
1 0 1 1 1 0 1 1 1 1 
1 2 0 1 1 0 1 0 1 0 
1 1 0 1 0 1 1 0 1 1 
0 0 1 1 0 1 1 1 0 0 
1 1 1 1 1 0 0 1 1 1 
1 1 1 1 1 1 1 1 1 1 
0 0 1 1 0 0 1 1 0 0 

Complexity: 4
Time: 288 seconds or 4.79 minutes or 0.08 hours