8 10
62
62 52 42 43 44 54 55 65 64 63 73 72 71 61 60 50 40 41 31 30 20 10 0 1 2 12 22 23 24 34 35 45 46 47 57 67 66 76 77 78 68 69 59 49 39 38 28 29 19 9 8 7 17 27 26 16 15 14 4 
1 1 1 0 1 0 0 1 1 1 
1 0 1 0 1 1 1 1 0 1 
1 0 1 1 1 0 1 1 1 1 
1 1 0 0 1 1 0 0 1 1 
1 1 1 1 1 1 1 1 0 1 
1 0 1 0 1 1 0 1 0 1 
1 1 2 1 1 1 1 1 1 1 
0 1 1 1 0 0 1 1 1 0 

Complexity: 4
Time: 585 seconds or 9.74 minutes or 0.16 hours