9 9
58
58 49 48 47 38 37 36 45 46 55 64 63 72 73 74 65 66 75 76 67 68 69 78 79 80 71 62 61 52 53 44 35 34 33 42 51 50 41 32 31 30 29 20 19 18 9 0 1 2 3 12 13 4 5 14 23 24 15 16 17 8 
1 1 1 1 1 1 0 0 1 
1 0 0 1 1 1 1 1 1 
1 1 1 0 0 1 1 0 0 
0 0 1 1 1 1 1 1 1 
1 1 1 0 0 1 1 0 1 
1 1 1 1 1 1 1 1 1 
0 1 0 0 2 0 0 1 1 
1 1 1 1 1 1 1 0 1 
1 1 1 1 1 0 1 1 1 

Complexity: 4
Time: 296 seconds or 4.93 minutes or 0.08 hours