8 10
18
18 19 9 8 7 6 5 4 14 15 16 26 27 28 38 39 49 59 69 79 78 68 58 57 47 46 56 66 76 75 74 64 63 73 72 62 52 53 54 44 45 35 34 33 32 22 23 13 12 2 1 11 10 20 30 40 41 51 50 60 70 
0 1 1 0 1 1 1 1 1 1 
1 1 1 1 1 1 1 0 2 1 
1 0 1 1 0 0 1 1 1 0 
1 0 1 1 1 1 0 0 1 1 
1 1 0 0 1 1 1 1 0 1 
1 1 1 1 1 0 1 1 1 1 
1 0 1 1 1 0 1 0 1 1 
1 0 1 1 1 1 1 0 1 1 

Complexity: 4
Time: 2004 seconds or 33.4 minutes or 0.56 hours