9 10
21
21 20 30 40 50 51 61 71 70 80 81 82 72 73 83 84 85 75 74 64 65 66 56 57 67 77 87 88 78 79 69 59 49 48 38 39 29 28 27 17 18 8 7 6 16 15 5 4 3 13 14 24 34 35 36 46 45 44 43 53 52 42 32 22 12 11 1 
0 1 0 1 1 1 1 1 1 0 
0 1 1 1 1 1 1 1 1 0 
1 2 1 0 1 0 0 1 1 1 
1 0 1 0 1 1 1 0 1 1 
1 0 1 1 1 1 1 0 1 1 
1 1 1 1 0 0 1 1 0 1 
0 1 0 0 1 1 1 1 0 1 
1 1 1 1 1 1 0 1 1 1 
1 1 1 1 1 1 0 1 1 0 

Complexity: 4
Time: 598 seconds or 9.97 minutes or 0.17 hours