9 10
74
74 84 85 75 65 55 56 57 47 37 36 35 45 44 43 53 63 73 72 82 81 80 70 71 61 51 50 40 41 42 32 22 21 20 10 0 1 2 3 13 23 24 25 15 5 6 16 17 7 8 9 19 18 28 29 39 49 59 58 68 78 77 76 86 87 88 89 
1 1 1 1 0 1 1 1 1 1 
1 0 0 1 0 1 1 1 1 1 
1 1 1 1 1 1 0 0 1 1 
0 0 1 0 0 1 1 1 0 1 
1 1 1 1 1 1 0 1 0 1 
1 1 0 1 0 1 1 1 1 1 
0 1 0 1 0 1 0 0 1 0 
1 1 1 1 2 1 1 1 1 0 
1 1 1 0 1 1 1 1 1 1 

Complexity: 4
Time: 3173 seconds or 52.88 minutes or 0.88 hours