8 10
44
44 54 55 56 57 67 77 78 79 69 59 49 39 38 48 47 46 45 35 25 26 27 17 18 19 9 8 7 6 5 4 14 13 3 2 1 11 10 20 30 31 21 22 23 33 43 42 41 51 50 60 61 71 72 62 63 73 74 75 65 
0 1 1 1 1 1 1 1 1 1 
1 1 0 1 1 0 0 1 1 1 
1 1 1 1 0 1 1 1 0 0 
1 1 0 1 0 1 0 0 1 1 
0 1 1 1 2 1 1 1 1 1 
1 1 0 0 1 1 1 1 0 1 
1 1 1 1 0 1 0 1 0 1 
0 1 1 1 1 1 0 1 1 1 

Complexity: 4
Time: 87 seconds or 1.45 minutes or 0.02 hours