9 8
24
24 25 17 16 8 0 1 9 10 11 12 4 5 6 7 15 23 31 30 22 21 20 19 27 28 36 37 45 53 54 46 47 55 63 71 70 69 68 60 59 51 43 42 34 33 32 40 41 49 57 58 66 65 64 
1 1 0 0 1 1 1 1 
1 1 1 1 1 0 0 1 
1 1 0 1 1 1 1 1 
2 1 0 1 1 0 1 1 
1 1 1 0 1 1 0 0 
1 1 1 1 0 1 1 1 
0 1 0 1 0 1 1 1 
0 1 1 1 1 0 0 1 
1 1 1 0 1 1 1 1 

Complexity: 3
Time: 18 seconds or 0.3 minutes or 0.01 hours