9 8
56
56 64 65 66 67 59 51 52 60 68 69 61 62 63 55 54 46 45 37 38 39 31 30 22 21 20 28 27 26 34 35 43 42 50 49 48 40 32 24 25 17 16 8 0 1 2 10 11 3 4 5 6 14 15 
1 1 1 1 1 1 1 0 
1 0 1 1 0 0 1 1 
1 1 0 0 1 1 1 0 
1 1 1 1 1 0 1 1 
1 0 1 1 0 1 1 1 
1 0 1 1 0 1 1 0 
1 1 1 1 1 0 1 1 
2 0 0 1 1 1 1 1 
1 1 1 1 1 1 0 0 

Complexity: 3
Time: 34 seconds or 0.56 minutes or 0.01 hours