9 8
52
52 51 50 42 41 33 32 40 48 56 64 65 57 58 59 60 68 69 70 71 63 55 54 53 45 46 38 39 31 23 15 7 6 14 13 21 29 28 36 35 27 26 18 17 16 8 0 1 2 10 11 12 4 
1 1 1 0 1 0 1 1 
1 0 1 1 1 1 1 1 
1 1 1 0 0 1 0 1 
0 0 1 1 1 1 0 1 
1 1 0 1 1 0 1 1 
1 1 1 0 0 1 1 0 
1 0 1 1 2 1 1 1 
1 1 1 1 1 0 0 1 
1 1 0 0 1 1 1 1 

Complexity: 3
Time: 166 seconds or 2.76 minutes or 0.05 hours