9 8
7
7 6 14 15 23 31 39 38 46 54 55 63 71 70 69 61 60 52 44 43 35 36 37 29 21 13 12 20 19 11 3 2 1 9 8 16 17 18 26 25 24 32 40 41 42 50 51 59 67 66 65 57 56 
0 1 1 1 0 0 1 2 
1 1 0 1 1 1 1 1 
1 1 1 1 1 1 0 1 
1 1 1 0 0 1 0 1 
1 0 0 1 1 1 1 1 
1 1 1 1 1 0 1 0 
0 0 1 1 1 0 1 1 
1 1 0 1 1 1 0 1 
0 1 1 1 0 1 1 1 

Complexity: 3
Time: 102 seconds or 1.71 minutes or 0.03 hours