9 8
42
42 43 35 27 28 29 30 31 23 22 14 6 5 13 12 4 3 11 19 18 10 2 1 0 8 16 24 25 33 32 40 41 49 48 56 64 65 66 58 59 67 68 69 70 62 61 60 52 53 45 37 38 39 47 55 
1 1 1 1 1 1 1 0 
1 0 1 1 1 1 1 0 
1 0 1 1 0 0 1 1 
1 1 0 1 1 1 1 1 
1 1 0 1 0 1 1 1 
1 1 2 1 0 1 0 1 
1 1 0 0 1 1 0 1 
1 0 1 1 1 1 1 0 
1 1 1 1 1 1 1 0 

Complexity: 3
Time: 12 seconds or 0.2 minutes or 0 hours