9 8
55
55 54 46 47 39 31 30 22 23 15 7 6 5 13 12 11 3 2 1 0 8 9 17 18 19 27 28 29 37 36 44 52 51 50 42 34 33 25 24 32 40 48 56 57 65 66 67 68 60 61 69 70 71 
1 1 1 1 0 1 1 1 
1 1 0 1 1 1 0 1 
0 1 1 1 0 0 1 1 
1 1 0 1 1 1 1 1 
1 1 1 0 1 1 0 1 
1 0 1 0 1 0 1 1 
1 0 1 1 1 0 1 2 
1 1 0 0 1 1 0 0 
0 1 1 1 1 1 1 1 

Complexity: 3
Time: 78 seconds or 1.3 minutes or 0.02 hours