9 8
41
41 42 50 51 43 35 36 28 20 21 13 14 15 7 6 5 4 12 11 3 2 1 9 8 16 17 18 26 25 24 32 40 48 56 57 58 66 67 68 60 61 53 45 37 38 30 31 39 47 55 54 62 70 71 
0 1 1 1 1 1 1 1 
1 1 0 1 1 1 1 1 
1 1 1 0 1 1 0 0 
1 1 1 0 1 0 1 1 
1 0 0 1 1 1 1 1 
1 2 1 1 0 1 0 1 
1 0 1 1 0 1 1 1 
1 1 1 0 1 1 1 0 
0 0 1 1 1 0 1 1 

Complexity: 3
Time: 12 seconds or 0.2 minutes or 0 hours