9 8
71
71 63 55 54 53 45 44 43 35 27 28 36 37 38 39 31 30 22 21 13 14 15 7 6 5 4 12 11 3 2 1 0 8 9 10 18 26 25 24 32 40 41 42 50 58 59 60 61 69 68 67 66 65 57 56 
1 1 1 1 1 1 1 1 
1 1 1 1 1 1 1 1 
0 0 1 0 0 1 1 0 
1 1 1 1 1 0 1 1 
1 0 0 1 1 1 1 1 
1 1 1 1 1 1 0 0 
0 0 1 0 0 1 1 1 
1 1 1 1 1 1 0 1 
0 1 1 1 1 1 0 2 

Complexity: 3
Time:  8 seconds or 0.14 minutes or 0 hours