9 8
15
15 14 6 5 4 3 2 1 9 10 11 12 20 21 22 23 31 39 38 37 45 44 36 28 27 19 18 17 16 24 25 33 34 42 41 40 48 49 57 56 64 65 66 67 59 51 52 60 61 69 70 71 63 55 54 
0 1 1 1 1 1 1 0 
0 1 1 1 1 0 1 2 
1 1 1 1 1 1 1 1 
1 1 0 1 1 0 0 1 
0 1 1 0 1 1 1 1 
1 1 1 0 1 1 0 0 
1 1 0 1 1 0 1 1 
1 1 0 1 1 1 0 1 
1 1 1 1 0 1 1 1 

Complexity: 3
Time: 169 seconds or 2.81 minutes or 0.05 hours