9 8
58
58 50 51 43 44 52 60 61 62 70 69 68 67 66 65 64 56 48 40 41 42 34 26 18 19 11 10 9 17 25 24 16 8 0 1 2 3 4 5 13 14 15 23 31 39 47 55 54 46 38 37 36 28 29 21 
1 1 1 1 1 1 0 0 
1 1 1 1 0 1 1 1 
1 1 1 1 0 1 0 1 
1 1 1 0 1 1 0 1 
0 0 1 0 1 1 1 1 
1 1 1 1 1 0 1 1 
1 0 1 1 1 0 1 1 
1 0 2 0 1 1 1 0 
1 1 1 1 1 1 1 0 

Complexity: 3
Time: 68 seconds or 1.13 minutes or 0.02 hours