9 8
30
30 31 23 15 14 13 5 4 3 11 10 2 1 0 8 16 17 25 24 32 40 48 49 41 33 34 26 27 28 20 21 29 37 45 44 43 51 59 58 57 65 66 67 68 69 70 71 63 62 61 53 54 46 47 
1 1 1 1 1 1 0 0 
1 0 1 1 0 1 1 1 
1 1 0 0 1 1 0 1 
1 1 1 1 1 1 2 1 
1 1 1 0 0 1 0 0 
1 1 0 1 1 1 1 1 
1 1 0 1 0 1 1 0 
0 1 1 1 0 1 1 1 
0 1 1 1 1 1 1 1 

Complexity: 3
Time: 93 seconds or 1.55 minutes or 0.03 hours