9 8
69
69 70 62 63 55 47 46 54 53 52 60 68 67 66 65 64 56 57 58 50 51 43 44 36 37 38 30 29 21 22 23 15 7 6 5 13 12 4 3 2 1 9 10 18 19 27 26 34 33 41 40 32 24 16 
0 1 1 1 1 1 1 1 
0 1 1 0 1 1 0 1 
1 0 1 1 0 1 1 1 
1 0 1 1 0 1 1 0 
1 1 1 0 1 1 1 0 
1 1 0 1 1 0 1 1 
0 0 1 1 1 1 1 1 
1 1 1 0 1 0 1 1 
1 1 1 1 1 2 1 0 

Complexity: 3
Time: 54 seconds or 0.9 minutes or 0.01 hours