9 8
66
66 65 64 56 48 49 50 42 34 33 32 24 16 8 0 1 9 17 18 10 11 12 4 5 13 21 20 19 27 35 36 37 45 44 52 60 59 67 68 69 70 71 63 62 54 55 47 39 31 30 22 14 15 7 
1 1 0 0 1 1 0 1 
1 1 1 1 1 1 1 1 
1 1 1 1 1 1 1 0 
1 0 0 1 0 0 1 1 
1 1 1 1 1 1 0 1 
0 0 1 0 1 1 0 1 
1 1 1 0 1 0 1 1 
1 0 0 1 1 0 1 1 
1 1 2 1 1 1 1 1 

Complexity: 3
Time: 30 seconds or 0.5 minutes or 0.01 hours