9 8
26
26 18 10 2 1 0 8 16 24 25 33 34 35 27 19 20 28 29 21 13 12 4 5 6 7 15 23 31 30 38 39 47 55 63 62 70 69 68 60 61 53 45 44 43 51 50 49 57 58 66 65 64 56 48 40 
1 1 1 0 1 1 1 1 
1 0 1 0 1 1 0 1 
1 0 1 1 1 1 0 1 
1 1 2 1 1 1 1 1 
0 1 1 1 0 0 1 1 
1 0 0 1 1 1 0 1 
1 1 1 1 0 1 0 1 
1 1 1 0 1 1 1 1 
1 1 1 0 1 1 1 0 

Complexity: 3
Time: 17 seconds or 0.28 minutes or 0 hours