9 8
21
21 20 12 4 3 2 1 9 8 16 24 32 33 34 26 18 10 11 19 27 28 36 44 45 53 52 51 50 42 41 40 48 49 57 65 66 67 59 60 68 69 70 62 63 55 47 39 38 30 31 23 15 14 6 5 
0 1 1 1 1 1 1 0 
1 1 1 1 1 0 1 1 
1 0 1 1 1 2 0 1 
1 0 1 1 1 0 1 1 
1 1 1 0 1 0 1 1 
1 1 1 0 1 1 0 1 
1 1 1 1 1 1 0 1 
0 1 0 1 1 0 1 1 
0 1 1 1 1 1 1 0 

Complexity: 3
Time: 18 seconds or 0.29 minutes or 0 hours