9 8
57
57 58 66 65 64 56 48 40 32 24 16 17 25 26 34 33 41 42 50 51 52 60 68 69 70 62 54 55 47 46 45 44 36 37 29 30 31 23 22 14 15 7 6 5 4 12 20 28 27 19 18 10 2 1 0 
1 1 1 0 1 1 1 1 
0 0 1 0 1 0 1 1 
1 1 1 1 1 0 1 1 
1 1 1 1 1 1 1 1 
1 1 1 0 1 1 0 0 
1 1 1 0 1 1 1 1 
1 0 1 1 1 0 1 1 
1 2 1 0 1 0 1 0 
1 1 1 0 1 1 1 0 

Complexity: 3
Time: 49 seconds or 0.82 minutes or 0.01 hours