9 8
29
29 21 20 12 11 10 2 3 4 5 6 14 15 23 31 39 38 37 45 44 43 35 27 26 25 17 9 8 16 24 32 33 41 40 48 56 64 65 57 58 50 51 59 67 68 60 61 62 54 46 47 55 63 71 
0 0 1 1 1 1 1 0 
1 1 1 1 1 0 1 1 
1 1 0 0 1 1 0 1 
1 1 1 1 0 2 0 1 
1 1 0 1 0 1 1 1 
1 1 0 1 1 1 1 1 
1 0 1 1 0 0 1 1 
1 1 1 1 1 1 1 1 
1 1 0 1 1 0 0 1 

Complexity: 3
Time: 56 seconds or 0.94 minutes or 0.02 hours