9 8
8
8 0 1 2 10 18 17 16 24 32 33 34 42 41 40 48 56 64 65 66 58 50 51 43 44 45 53 61 60 68 69 70 71 63 55 47 46 38 37 29 28 27 19 20 21 13 12 4 5 6 14 15 23 31 
1 1 1 0 1 1 1 0 
2 0 1 0 1 1 1 1 
1 1 1 1 1 1 0 1 
1 0 0 1 1 1 0 1 
1 1 1 0 0 1 1 0 
1 1 1 1 1 1 1 1 
1 0 1 1 0 1 0 1 
1 0 1 0 1 1 0 1 
1 1 1 0 1 1 1 1 

Complexity: 3
Time: 26 seconds or 0.43 minutes or 0.01 hours