9 8
11
11 19 20 21 22 30 29 28 27 26 34 35 43 44 45 46 38 39 47 55 54 62 70 69 61 60 68 67 59 51 50 58 57 65 64 56 48 40 41 33 32 24 16 17 9 8 0 1 2 3 4 5 6 14 15 
1 1 1 1 1 1 1 0 
1 1 0 2 0 0 1 1 
1 1 0 1 1 1 1 0 
1 0 1 1 1 1 1 0 
1 1 1 1 0 0 1 1 
1 1 0 1 1 1 1 1 
1 0 1 1 0 0 1 1 
1 1 1 1 1 1 1 0 
1 1 0 1 1 1 1 0 

Complexity: 3
Time: 17 seconds or 0.29 minutes or 0 hours