9 8
62
62 63 55 47 46 38 30 29 28 36 44 52 53 61 69 68 60 59 67 66 65 64 56 48 49 50 42 34 35 27 19 20 21 22 23 15 14 6 5 4 3 11 10 2 1 0 8 16 17 25 33 32 
1 1 1 1 1 1 1 0 
1 0 1 1 0 0 1 1 
1 1 0 1 1 1 1 1 
0 1 0 1 1 1 1 0 
1 1 1 1 1 0 1 0 
0 0 1 0 1 0 1 1 
1 1 1 0 1 1 0 1 
1 0 0 1 1 1 2 1 
1 1 1 1 1 1 0 0 

Complexity: 3
Time: 48 seconds or 0.8 minutes or 0.01 hours