9 8
10
10 9 1 2 3 11 12 4 5 6 14 15 23 31 39 38 37 29 21 20 28 27 26 25 17 16 24 32 33 34 42 50 49 48 56 64 65 66 67 68 60 59 51 43 44 45 53 61 62 70 71 63 55 47 
0 1 1 1 1 1 1 0 
0 1 2 1 1 0 1 1 
1 1 0 0 1 1 0 1 
1 1 1 1 1 1 0 1 
1 1 1 0 0 1 1 1 
0 0 1 1 1 1 0 1 
1 1 1 1 0 1 0 1 
1 0 0 1 1 1 1 1 
1 1 1 1 1 0 1 1 

Complexity: 3
Time: 58 seconds or 0.96 minutes or 0.02 hours