9 8
57
57 49 48 56 64 65 66 67 59 58 50 42 43 44 52 53 61 69 70 71 63 55 47 46 45 37 36 28 29 30 31 23 22 14 15 7 6 5 4 12 20 19 11 3 2 1 9 8 16 17 25 26 34 33 32 
0 1 1 1 1 1 1 1 
1 1 0 1 1 0 1 1 
1 1 0 1 1 0 1 1 
0 1 1 0 1 1 1 1 
1 1 1 0 1 1 0 0 
0 0 1 1 1 1 1 1 
1 1 1 0 1 1 0 1 
1 2 1 1 0 1 0 1 
1 1 1 1 0 1 1 1 

Complexity: 3
Time: 39 seconds or 0.66 minutes or 0.01 hours