9 8
58
58 50 51 59 67 68 60 61 69 70 71 63 55 54 46 38 30 31 23 15 14 13 5 4 3 11 12 20 21 29 37 45 44 43 35 27 26 18 10 9 1 0 8 16 24 32 33 41 40 48 56 57 65 
1 1 0 1 1 1 0 0 
1 1 1 1 1 1 1 1 
1 0 1 0 1 1 0 1 
1 0 1 1 0 1 1 1 
1 1 0 1 0 1 1 0 
1 1 0 1 1 1 1 0 
1 0 1 1 0 0 1 1 
1 1 2 1 1 1 0 1 
0 1 0 1 1 1 1 1 

Complexity: 3
Time: 114 seconds or 1.9 minutes or 0.03 hours